aaron	MALE
abbey	FEMALE
abbie	FEMALE
abby	FEMALE
abdul	MALE
abe	MALE
abel	MALE
abigail	FEMALE
abraham	MALE
abram	MALE
ada	FEMALE
adalberto	MALE
adam	MALE
adan	MALE
addie	FEMALE
adela	FEMALE
adelaida	FEMALE
adelaide	FEMALE
adele	FEMALE
adelia	FEMALE
adelina	FEMALE
adeline	FEMALE
adell	FEMALE
adella	FEMALE
adelle	FEMALE
adina	FEMALE
adolfo	MALE
adolph	MALE
adria	FEMALE
adrian	MALE
adriana	FEMALE
adriane	FEMALE
adrianna	FEMALE
adrianne	FEMALE
adrienne	FEMALE
afton	FEMALE
agatha	FEMALE
agnes	FEMALE
agustin	MALE
agustina	FEMALE
ahmad	MALE
ahmed	MALE
aida	FEMALE
aileen	FEMALE
aimee	FEMALE
aisha	FEMALE
aja	FEMALE
akiko	FEMALE
al	MALE
alaina	FEMALE
alan	MALE
alana	FEMALE
alanna	FEMALE
alba	FEMALE
albert	MALE
alberta	FEMALE
albertha	FEMALE
albertina	FEMALE
albertine	FEMALE
alberto	MALE
albina	FEMALE
alda	FEMALE
alden	MALE
aldo	MALE
alec	MALE
alecia	FEMALE
aleida	FEMALE
alejandra	FEMALE
alejandrina	FEMALE
alejandro	MALE
alena	FEMALE
alene	FEMALE
alesha	FEMALE
alesia	FEMALE
aleta	FEMALE
aletha	FEMALE
alethea	FEMALE
alethia	FEMALE
alex	MALE
alexa	FEMALE
alexander	MALE
alexandra	FEMALE
alexandria	FEMALE
alexia	FEMALE
alexis	FEMALE
alfonso	MALE
alfonzo	MALE
alfred	MALE
alfreda	FEMALE
alfredo	MALE
ali	MALE
alia	FEMALE
alica	FEMALE
alice	FEMALE
alicia	FEMALE
alida	FEMALE
alina	FEMALE
aline	FEMALE
alisa	FEMALE
alise	FEMALE
alisha	FEMALE
alisia	FEMALE
alison	FEMALE
alissa	FEMALE
alix	FEMALE
alla	FEMALE
allan	MALE
allegra	FEMALE
allen	MALE
allene	FEMALE
allie	FEMALE
alline	FEMALE
allison	FEMALE
allyson	FEMALE
alma	FEMALE
almeda	FEMALE
almeta	FEMALE
alonso	MALE
alonzo	MALE
alpha	FEMALE
alphonse	MALE
alphonso	MALE
alta	FEMALE
altagracia	FEMALE
altha	FEMALE
althea	FEMALE
alton	MALE
alva	FEMALE
alva	MALE
alvaro	MALE
alvera	FEMALE
alvin	MALE
alvina	FEMALE
alyce	FEMALE
alycia	FEMALE
alyse	FEMALE
alysha	FEMALE
alysia	FEMALE
alyson	FEMALE
alyssa	FEMALE
amada	FEMALE
amado	MALE
amalia	FEMALE
amanda	FEMALE
amber	FEMALE
ambrose	MALE
amelia	FEMALE
america	FEMALE
ami	FEMALE
amie	FEMALE
amina	FEMALE
ammie	FEMALE
amos	MALE
amparo	FEMALE
amy	FEMALE
ana	FEMALE
anabel	FEMALE
anastacia	FEMALE
anastasia	FEMALE
anderson	MALE
andra	FEMALE
andre	MALE
andrea	FEMALE
andreas	MALE
andree	FEMALE
andres	MALE
andrew	MALE
andria	FEMALE
andy	MALE
anette	FEMALE
angel	FEMALE
angela	FEMALE
angele	FEMALE
angeles	FEMALE
angelia	FEMALE
angelic	FEMALE
angelica	FEMALE
angelika	FEMALE
angelina	FEMALE
angeline	FEMALE
angelique	FEMALE
angelita	FEMALE
angella	FEMALE
angelo	MALE
angie	FEMALE
angle	FEMALE
anglea	FEMALE
anh	FEMALE
anibal	MALE
anika	FEMALE
anissa	FEMALE
anita	FEMALE
anitra	FEMALE
anjanette	FEMALE
ann	FEMALE
anna	FEMALE
annabel	FEMALE
annabell	FEMALE
annabelle	FEMALE
annalee	FEMALE
annalisa	FEMALE
annamae	FEMALE
annamarie	FEMALE
anne	FEMALE
anneliese	FEMALE
annemarie	FEMALE
annetta	FEMALE
annette	FEMALE
annice	FEMALE
annie	FEMALE
annis	FEMALE
annmarie	FEMALE
anthony	MALE
antione	MALE
antionette	FEMALE
antoine	MALE
antoinette	FEMALE
anton	MALE
antone	MALE
antonette	FEMALE
antonia	FEMALE
antonietta	FEMALE
antonina	FEMALE
antonio	MALE
antony	MALE
antwan	MALE
anya	FEMALE
april	FEMALE
araceli	FEMALE
aracely	FEMALE
arcelia	FEMALE
archie	MALE
ardell	FEMALE
ardella	FEMALE
arden	MALE
ardis	FEMALE
ardith	FEMALE
aretha	FEMALE
ariana	FEMALE
arianna	FEMALE
arielle	FEMALE
arla	FEMALE
arleen	FEMALE
arlen	MALE
arlena	FEMALE
arlene	FEMALE
arletta	FEMALE
arlette	FEMALE
arlie	MALE
arline	FEMALE
armand	MALE
armando	MALE
armida	FEMALE
arminda	FEMALE
arnetta	FEMALE
arnita	FEMALE
arnold	MALE
arnoldo	MALE
arnulfo	MALE
aron	MALE
arron	MALE
art	MALE
arthur	MALE
artie	FEMALE
arturo	MALE
arvilla	FEMALE
asa	MALE
asha	FEMALE
ashely	FEMALE
ashlee	FEMALE
ashleigh	FEMALE
ashley	FEMALE
ashli	FEMALE
ashlie	FEMALE
ashly	FEMALE
ashlyn	FEMALE
ashton	FEMALE
asia	FEMALE
assunta	FEMALE
astrid	FEMALE
asuncion	FEMALE
athena	FEMALE
aubrey	MALE
audie	FEMALE
audra	FEMALE
audrea	FEMALE
audrey	FEMALE
audry	FEMALE
august	MALE
augusta	FEMALE
augustina	FEMALE
augustine	MALE
augustus	MALE
aundrea	FEMALE
aura	FEMALE
aurea	FEMALE
aurelia	FEMALE
aurelio	MALE
aurora	FEMALE
austin	MALE
autumn	FEMALE
ava	FEMALE
avelina	FEMALE
avery	MALE
avis	FEMALE
awilda	FEMALE
ayana	FEMALE
ayanna	FEMALE
ayesha	FEMALE
azucena	FEMALE
babara	FEMALE
babette	FEMALE
bailey	FEMALE
bambi	FEMALE
barb	FEMALE
barbar	FEMALE
barbara	FEMALE
barbera	FEMALE
barbie	FEMALE
barbra	FEMALE
barney	MALE
barrett	MALE
barry	MALE
bart	MALE
barton	MALE
basil	MALE
bea	FEMALE
beatrice	FEMALE
beatriz	FEMALE
beau	MALE
beckie	FEMALE
becky	FEMALE
belen	FEMALE
belia	FEMALE
belinda	FEMALE
bella	FEMALE
belle	FEMALE
belva	FEMALE
ben	MALE
benedict	MALE
benita	FEMALE
benito	MALE
benjamin	MALE
bennett	MALE
bennie	FEMALE
bennie	MALE
benny	MALE
benton	MALE
berenice	FEMALE
bernadette	FEMALE
bernadine	FEMALE
bernard	MALE
bernardo	MALE
berneice	FEMALE
bernetta	FEMALE
bernice	FEMALE
bernie	MALE
berniece	FEMALE
bernita	FEMALE
berry	MALE
bert	MALE
berta	FEMALE
bertha	FEMALE
bertie	FEMALE
bertram	MALE
beryl	FEMALE
bess	FEMALE
bessie	FEMALE
beth	FEMALE
bethann	FEMALE
bethany	FEMALE
bethel	FEMALE
betsey	FEMALE
betsy	FEMALE
bette	FEMALE
bettie	FEMALE
bettina	FEMALE
betty	FEMALE
bettye	FEMALE
beulah	FEMALE
bev	FEMALE
beverlee	FEMALE
beverley	FEMALE
beverly	FEMALE
bianca	FEMALE
bill	MALE
billie	FEMALE
billie	MALE
billy	MALE
billye	FEMALE
birdie	FEMALE
birgit	FEMALE
blaine	MALE
blair	FEMALE
blair	MALE
blake	MALE
blanca	FEMALE
blanch	FEMALE
blanche	FEMALE
blythe	FEMALE
bo	MALE
bob	MALE
bobbi	FEMALE
bobbie	MALE
bobby	MALE
bobbye	FEMALE
bonita	FEMALE
bonnie	FEMALE
bonny	FEMALE
booker	MALE
boris	MALE
boyce	MALE
boyd	MALE
brad	MALE
bradford	MALE
bradley	MALE
bradly	MALE
brady	MALE
brain	MALE
branda	FEMALE
brandee	FEMALE
branden	MALE
brandi	FEMALE
brandie	FEMALE
brandon	MALE
brandy	FEMALE
brant	MALE
breanna	FEMALE
breanne	FEMALE
bree	FEMALE
brenda	FEMALE
brendan	MALE
brendon	MALE
brenna	FEMALE
brent	MALE
brenton	MALE
bret	MALE
brett	MALE
brian	MALE
briana	FEMALE
brianna	FEMALE
brianne	FEMALE
brice	MALE
bridget	FEMALE
bridgett	FEMALE
bridgette	FEMALE
brigette	FEMALE
brigid	FEMALE
brigida	FEMALE
brigitte	FEMALE
brinda	FEMALE
britany	FEMALE
britney	FEMALE
britni	FEMALE
britt	MALE
brittani	FEMALE
brittany	FEMALE
brittney	FEMALE
brittni	FEMALE
brock	MALE
broderick	MALE
bronwyn	FEMALE
brook	FEMALE
brooke	FEMALE
brooks	MALE
bruce	MALE
brunilda	FEMALE
bruno	MALE
bryan	MALE
bryant	MALE
bryce	MALE
brynn	FEMALE
bryon	MALE
buck	MALE
bud	MALE
buddy	MALE
buffy	FEMALE
buford	MALE
burl	MALE
burt	MALE
burton	MALE
buster	MALE
byron	MALE
caitlin	FEMALE
caitlyn	FEMALE
caleb	MALE
callie	FEMALE
calvin	MALE
camelia	FEMALE
cameron	MALE
cami	FEMALE
camilla	FEMALE
camille	FEMALE
cammie	FEMALE
candace	FEMALE
candance	FEMALE
candelaria	FEMALE
candi	FEMALE
candice	FEMALE
candida	FEMALE
candie	FEMALE
candis	FEMALE
candy	FEMALE
candyce	FEMALE
caprice	FEMALE
cara	FEMALE
caren	FEMALE
carey	FEMALE
cari	FEMALE
caridad	FEMALE
carie	FEMALE
carin	FEMALE
carina	FEMALE
carisa	FEMALE
carissa	FEMALE
carl	MALE
carla	FEMALE
carleen	FEMALE
carlene	FEMALE
carletta	FEMALE
carley	FEMALE
carlie	FEMALE
carline	FEMALE
carlo	MALE
carlos	MALE
carlota	FEMALE
carlotta	FEMALE
carlton	MALE
carly	FEMALE
carlyn	FEMALE
carma	FEMALE
carman	FEMALE
carmel	FEMALE
carmela	FEMALE
carmelina	FEMALE
carmelita	FEMALE
carmella	FEMALE
carmelo	MALE
carmen	FEMALE
carmine	MALE
carmon	FEMALE
carol	FEMALE
carolann	FEMALE
carole	FEMALE
carolee	FEMALE
carolina	FEMALE
caroline	FEMALE
carolyn	FEMALE
carolyne	FEMALE
carolynn	FEMALE
caron	FEMALE
carri	FEMALE
carrie	FEMALE
carrol	FEMALE
carroll	FEMALE
carson	MALE
carter	MALE
cary	FEMALE
cary	MALE
caryl	FEMALE
caryn	FEMALE
casandra	FEMALE
casey	FEMALE
casey	MALE
casie	FEMALE
cassandra	FEMALE
cassidy	FEMALE
cassie	FEMALE
catalina	FEMALE
catarina	FEMALE
caterina	FEMALE
catharine	FEMALE
catherine	FEMALE
cathey	FEMALE
cathi	FEMALE
cathie	FEMALE
cathleen	FEMALE
cathrine	FEMALE
cathryn	FEMALE
cathy	FEMALE
catina	FEMALE
catrina	FEMALE
cecelia	FEMALE
cecil	MALE
cecila	FEMALE
cecile	FEMALE
cecilia	FEMALE
cecily	FEMALE
cedric	MALE
cedrick	MALE
celena	FEMALE
celeste	FEMALE
celestina	FEMALE
celestine	FEMALE
celia	FEMALE
celina	FEMALE
celine	FEMALE
cesar	MALE
chad	MALE
chadwick	MALE
chana	FEMALE
chance	MALE
chanda	FEMALE
chandra	FEMALE
chanel	FEMALE
chantal	FEMALE
chante	FEMALE
chantel	FEMALE
chantell	FEMALE
chantelle	FEMALE
charise	FEMALE
charissa	FEMALE
charisse	FEMALE
charity	FEMALE
charla	FEMALE
charleen	FEMALE
charlene	FEMALE
charles	MALE
charlette	FEMALE
charley	MALE
charlie	MALE
charline	FEMALE
charlotte	FEMALE
charmaine	FEMALE
charolette	FEMALE
chas	MALE
chase	MALE
chasity	FEMALE
chastity	FEMALE
chau	FEMALE
chauncey	MALE
chaya	FEMALE
chelsea	FEMALE
chelsey	FEMALE
chelsie	FEMALE
cheri	FEMALE
cherie	FEMALE
cherise	FEMALE
cherish	FEMALE
cherly	FEMALE
cherri	FEMALE
cherrie	FEMALE
cherry	FEMALE
cherryl	FEMALE
cheryl	FEMALE
cheryle	FEMALE
cheryll	FEMALE
chester	MALE
chet	MALE
cheyenne	FEMALE
chi	FEMALE
chi	MALE
chin	FEMALE
chiquita	FEMALE
chloe	FEMALE
chris	MALE
chrissy	FEMALE
christa	FEMALE
christal	FEMALE
christeen	FEMALE
christel	FEMALE
christen	FEMALE
christena	FEMALE
christene	FEMALE
christi	FEMALE
christian	MALE
christiana	FEMALE
christiane	FEMALE
christie	FEMALE
christin	FEMALE
christina	FEMALE
christine	FEMALE
christoper	MALE
christopher	MALE
christy	FEMALE
chrystal	FEMALE
chuck	MALE
chun	FEMALE
chung	FEMALE
chung	MALE
ciara	FEMALE
cicely	FEMALE
ciera	FEMALE
cierra	FEMALE
cinda	FEMALE
cindi	FEMALE
cindy	FEMALE
cinthia	FEMALE
clair	FEMALE
claire	FEMALE
clara	FEMALE
clare	FEMALE
clarence	MALE
claribel	FEMALE
clarice	FEMALE
clarine	FEMALE
clarissa	FEMALE
clarita	FEMALE
clark	MALE
claud	MALE
claude	MALE
claudette	FEMALE
claudia	FEMALE
claudine	FEMALE
claudio	MALE
clay	MALE
clayton	MALE
clement	MALE
clemente	MALE
clementina	FEMALE
clementine	FEMALE
clemmie	FEMALE
cleo	FEMALE
cleopatra	FEMALE
cleora	FEMALE
cleta	FEMALE
cletus	MALE
cleveland	MALE
cliff	MALE
clifford	MALE
clifton	MALE
clint	MALE
clinton	MALE
clotilde	FEMALE
clyde	FEMALE
clyde	MALE
cody	MALE
colby	MALE
cole	MALE
coleen	FEMALE
coleman	MALE
coletta	FEMALE
colette	FEMALE
colin	MALE
colleen	FEMALE
collen	FEMALE
collette	FEMALE
collin	MALE
colton	MALE
columbus	MALE
concepcion	FEMALE
concetta	FEMALE
conchita	FEMALE
connie	FEMALE
conrad	MALE
constance	FEMALE
consuela	FEMALE
consuelo	FEMALE
cora	FEMALE
coral	FEMALE
corazon	FEMALE
cordelia	FEMALE
cordell	MALE
cordie	FEMALE
coreen	FEMALE
corene	FEMALE
coretta	FEMALE
corey	FEMALE
cori	FEMALE
corie	FEMALE
corina	FEMALE
corine	FEMALE
corinna	FEMALE
corinne	FEMALE
corliss	FEMALE
cornelia	FEMALE
cornelius	MALE
cornell	MALE
corrie	FEMALE
corrina	FEMALE
corrine	FEMALE
cortez	MALE
cortney	FEMALE
cory	MALE
courtney	FEMALE
coy	MALE
craig	MALE
crissy	FEMALE
crista	FEMALE
cristal	FEMALE
cristen	FEMALE
cristi	FEMALE
cristie	FEMALE
cristin	FEMALE
cristina	FEMALE
cristine	FEMALE
cristobal	MALE
cristopher	MALE
cristy	FEMALE
cruz	MALE
crystal	FEMALE
curt	MALE
curtis	MALE
cyndi	FEMALE
cynthia	FEMALE
cyril	MALE
cyrus	MALE
cythia	FEMALE
dagmar	FEMALE
dahlia	FEMALE
daisey	FEMALE
daisy	FEMALE
dale	MALE
dalia	FEMALE
dalila	FEMALE
dallas	MALE
dalton	MALE
damaris	FEMALE
damian	MALE
damien	MALE
damion	MALE
damon	MALE
dan	MALE
dana	FEMALE
danae	FEMALE
dane	MALE
danelle	FEMALE
danette	FEMALE
dani	FEMALE
dania	FEMALE
danial	MALE
danica	FEMALE
daniel	MALE
daniela	FEMALE
daniele	FEMALE
daniella	FEMALE
danielle	FEMALE
danika	FEMALE
danilo	MALE
danita	FEMALE
danna	FEMALE
dannette	FEMALE
dannie	MALE
dannielle	FEMALE
danny	MALE
dante	MALE
danuta	FEMALE
danyelle	FEMALE
daphine	FEMALE
daphne	FEMALE
dara	FEMALE
darby	FEMALE
darci	FEMALE
darcie	FEMALE
darcy	FEMALE
darell	MALE
daren	MALE
daria	FEMALE
darin	MALE
dario	MALE
darius	MALE
darla	FEMALE
darleen	FEMALE
darlene	FEMALE
darline	FEMALE
darnell	MALE
daron	MALE
darrel	MALE
darrell	MALE
darren	MALE
darrick	MALE
darrin	MALE
darron	MALE
darryl	MALE
darwin	MALE
daryl	MALE
dave	MALE
david	MALE
davida	FEMALE
davina	FEMALE
davis	MALE
dawn	FEMALE
dawna	FEMALE
dawne	FEMALE
dayle	FEMALE
dayna	FEMALE
dean	MALE
deana	FEMALE
deandra	FEMALE
deandre	MALE
deane	FEMALE
deangelo	MALE
deann	FEMALE
deanna	FEMALE
deanne	FEMALE
deb	FEMALE
debbi	FEMALE
debbie	FEMALE
debbra	FEMALE
debby	FEMALE
debi	FEMALE
debora	FEMALE
deborah	FEMALE
debra	FEMALE
debrah	FEMALE
debroah	FEMALE
dedra	FEMALE
dee	FEMALE
dee	MALE
deeann	FEMALE
deena	FEMALE
deidra	FEMALE
deidre	FEMALE
deirdre	FEMALE
del	MALE
delana	FEMALE
delbert	MALE
delena	FEMALE
delfina	FEMALE
delia	FEMALE
delicia	FEMALE
delilah	FEMALE
delinda	FEMALE
delisa	FEMALE
dell	FEMALE
della	FEMALE
delma	FEMALE
delmar	MALE
delmer	MALE
delois	FEMALE
delora	FEMALE
delores	FEMALE
deloris	FEMALE
delpha	FEMALE
delphia	FEMALE
delphine	FEMALE
delta	FEMALE
demarcus	MALE
demetra	FEMALE
demetria	FEMALE
demetrice	FEMALE
demetrius	MALE
dena	FEMALE
deneen	FEMALE
denese	FEMALE
denice	FEMALE
denis	MALE
denise	FEMALE
denisha	FEMALE
denita	FEMALE
denna	FEMALE
dennis	MALE
dennise	FEMALE
denny	MALE
denver	MALE
deon	MALE
derek	MALE
derick	MALE
derrick	MALE
deshawn	MALE
desirae	FEMALE
desire	FEMALE
desiree	FEMALE
desmond	MALE
dessie	FEMALE
destiny	FEMALE
detra	FEMALE
devin	MALE
devon	FEMALE
devon	MALE
devona	FEMALE
devorah	FEMALE
dewayne	MALE
dewey	MALE
dewitt	MALE
dexter	MALE
diamond	FEMALE
dian	FEMALE
diana	FEMALE
diane	FEMALE
diann	FEMALE
dianna	FEMALE
dianne	FEMALE
dick	MALE
diedra	FEMALE
diedre	FEMALE
diego	MALE
digna	FEMALE
dillon	MALE
dina	FEMALE
dinah	FEMALE
dino	MALE
dion	MALE
dione	FEMALE
dionna	FEMALE
dionne	FEMALE
dirk	MALE
dixie	FEMALE
dollie	FEMALE
dolly	FEMALE
dolores	FEMALE
doloris	FEMALE
domenic	MALE
domenica	FEMALE
dominga	FEMALE
domingo	MALE
dominic	MALE
dominick	MALE
dominique	FEMALE
dominque	FEMALE
domonique	FEMALE
don	MALE
dona	FEMALE
donald	MALE
donetta	FEMALE
dong	MALE
donita	FEMALE
donn	MALE
donna	FEMALE
donnell	MALE
donnie	MALE
donny	MALE
donovan	MALE
donte	MALE
donya	FEMALE
dora	FEMALE
dorathy	FEMALE
dorcas	FEMALE
doreen	FEMALE
dorene	FEMALE
doretha	FEMALE
dori	FEMALE
dorian	MALE
dorie	FEMALE
dorinda	FEMALE
dorine	FEMALE
doris	FEMALE
dorotha	FEMALE
dorothea	FEMALE
dorothy	FEMALE
dorris	FEMALE
dorsey	MALE
dortha	FEMALE
dorthea	FEMALE
dorthy	FEMALE
dot	FEMALE
dottie	FEMALE
doug	MALE
douglas	MALE
douglass	MALE
dovie	FEMALE
doyle	MALE
dreama	FEMALE
drema	FEMALE
drew	MALE
drucilla	FEMALE
drusilla	FEMALE
duane	MALE
dudley	MALE
dulce	FEMALE
duncan	MALE
dung	FEMALE
dustin	MALE
dusty	MALE
dwain	MALE
dwayne	MALE
dwight	MALE
dyan	FEMALE
dylan	MALE
earl	MALE
earle	MALE
earlean	FEMALE
earleen	FEMALE
earlene	FEMALE
earline	FEMALE
earnest	MALE
earnestine	FEMALE
eartha	FEMALE
easter	FEMALE
eboni	FEMALE
ebony	FEMALE
echo	FEMALE
ed	MALE
eda	FEMALE
edda	FEMALE
eddie	MALE
eddy	MALE
edelmira	FEMALE
eden	FEMALE
edgar	MALE
edgardo	MALE
edie	FEMALE
edison	MALE
edith	FEMALE
edmond	MALE
edmund	MALE
edmundo	MALE
edna	FEMALE
eduardo	MALE
edward	MALE
edwardo	MALE
edwin	MALE
edwina	FEMALE
edythe	FEMALE
effie	FEMALE
efrain	MALE
efren	MALE
eileen	FEMALE
elaina	FEMALE
elaine	FEMALE
elana	FEMALE
elanor	FEMALE
elayne	FEMALE
elba	FEMALE
elbert	MALE
elda	FEMALE
elden	MALE
eldon	MALE
eldora	FEMALE
eldridge	MALE
eleanor	FEMALE
eleanora	FEMALE
eleanore	FEMALE
elease	FEMALE
elena	FEMALE
eleni	FEMALE
elenor	FEMALE
elenora	FEMALE
elfriede	FEMALE
eli	MALE
elia	FEMALE
eliana	FEMALE
elias	MALE
elicia	FEMALE
elida	FEMALE
elijah	MALE
elinor	FEMALE
elisa	FEMALE
elisabeth	FEMALE
elise	FEMALE
eliseo	MALE
elisha	FEMALE
elisha	MALE
elissa	FEMALE
eliza	FEMALE
elizabeth	FEMALE
elizbeth	FEMALE
elizebeth	FEMALE
elke	FEMALE
ella	FEMALE
ellen	FEMALE
ellie	FEMALE
elliot	MALE
elliott	MALE
ellis	MALE
ellsworth	MALE
elly	FEMALE
ellyn	FEMALE
elma	FEMALE
elmer	MALE
elmira	FEMALE
elmo	MALE
elna	FEMALE
elnora	FEMALE
elodia	FEMALE
elois	FEMALE
eloisa	FEMALE
eloise	FEMALE
elouise	FEMALE
eloy	MALE
elroy	MALE
elsa	FEMALE
else	FEMALE
elsie	FEMALE
elton	MALE
elva	FEMALE
elvera	FEMALE
elvia	FEMALE
elvie	FEMALE
elvin	MALE
elvina	FEMALE
elvira	FEMALE
elvis	MALE
elwood	MALE
elyse	FEMALE
ema	FEMALE
emanuel	MALE
emelda	FEMALE
emelia	FEMALE
emerson	MALE
emery	MALE
emiko	FEMALE
emil	MALE
emile	MALE
emilee	FEMALE
emilia	FEMALE
emilie	FEMALE
emilio	MALE
emily	FEMALE
emma	FEMALE
emmanuel	MALE
emmett	MALE
emmie	FEMALE
emmitt	MALE
emmy	FEMALE
emogene	FEMALE
emory	MALE
ena	FEMALE
enedina	FEMALE
eneida	FEMALE
enid	FEMALE
enoch	MALE
enola	FEMALE
enrique	MALE
enriqueta	FEMALE
epifania	FEMALE
era	FEMALE
erasmo	MALE
eric	MALE
erica	FEMALE
erich	MALE
erick	MALE
ericka	FEMALE
erik	MALE
erika	FEMALE
erin	FEMALE
erlene	FEMALE
erlinda	FEMALE
erline	FEMALE
erma	FEMALE
ermelinda	FEMALE
erna	FEMALE
ernest	MALE
ernestina	FEMALE
ernestine	FEMALE
ernesto	MALE
ernie	MALE
errol	MALE
ervin	MALE
erwin	MALE
esmeralda	FEMALE
esperanza	FEMALE
essie	FEMALE
esta	FEMALE
esteban	MALE
estela	FEMALE
estell	FEMALE
estella	FEMALE
estelle	FEMALE
ester	FEMALE
esther	FEMALE
estrella	FEMALE
ethan	MALE
ethel	FEMALE
ethelene	FEMALE
ethelyn	FEMALE
ethyl	FEMALE
etta	FEMALE
eugene	MALE
eugenia	FEMALE
eugenie	FEMALE
eugenio	MALE
eula	FEMALE
eulalia	FEMALE
eun	FEMALE
eunice	FEMALE
eusebio	MALE
eva	FEMALE
evalyn	FEMALE
evan	MALE
evangelina	FEMALE
evangeline	FEMALE
eve	FEMALE
evelia	FEMALE
evelin	FEMALE
evelina	FEMALE
eveline	FEMALE
evelyn	FEMALE
evelyne	FEMALE
everett	MALE
everette	MALE
evette	FEMALE
evie	FEMALE
evon	FEMALE
evonne	FEMALE
exie	FEMALE
ezekiel	MALE
ezequiel	MALE
ezra	MALE
fabian	MALE
fabiola	FEMALE
fae	FEMALE
faith	FEMALE
fallon	FEMALE
fannie	FEMALE
fanny	FEMALE
farah	FEMALE
farrah	FEMALE
fatima	FEMALE
faustina	FEMALE
faustino	MALE
fausto	MALE
fawn	FEMALE
fay	FEMALE
faye	FEMALE
fe	FEMALE
federico	MALE
felecia	FEMALE
felica	FEMALE
felice	FEMALE
felicia	FEMALE
felicita	FEMALE
felicitas	FEMALE
felipa	FEMALE
felipe	MALE
felisa	FEMALE
felisha	FEMALE
felix	MALE
felton	MALE
ferdinand	MALE
fermin	MALE
fern	FEMALE
fernanda	FEMALE
fernando	MALE
ferne	FEMALE
fidel	MALE
filiberto	MALE
filomena	FEMALE
fiona	FEMALE
flavia	FEMALE
fletcher	MALE
flo	FEMALE
flor	FEMALE
flora	FEMALE
florance	FEMALE
florence	FEMALE
florencia	FEMALE
florencio	MALE
florene	FEMALE
florentina	FEMALE
florentino	MALE
floretta	FEMALE
florida	FEMALE
florinda	FEMALE
florine	FEMALE
flossie	FEMALE
floy	FEMALE
floyd	MALE
fonda	FEMALE
forest	MALE
forrest	MALE
foster	MALE
fran	FEMALE
france	FEMALE
frances	FEMALE
frances	MALE
francesca	FEMALE
francesco	MALE
francie	FEMALE
francina	FEMALE
francine	FEMALE
francis	MALE
francisca	FEMALE
francisco	MALE
frank	MALE
frankie	FEMALE
frankie	MALE
franklin	MALE
franklyn	MALE
fred	MALE
freda	FEMALE
freddie	MALE
freddy	MALE
frederic	MALE
frederica	FEMALE
frederick	MALE
fredericka	FEMALE
fredia	FEMALE
fredric	MALE
fredrick	MALE
freeda	FEMALE
freeman	MALE
freida	FEMALE
frieda	FEMALE
fritz	MALE
fumiko	FEMALE
gabriel	MALE
gabriela	FEMALE
gabriele	FEMALE
gabriella	FEMALE
gabrielle	FEMALE
gail	FEMALE
gale	FEMALE
galen	MALE
garfield	MALE
garland	MALE
garnet	FEMALE
garnett	FEMALE
garret	MALE
garrett	MALE
garry	MALE
garth	MALE
gary	MALE
gaston	MALE
gavin	MALE
gay	FEMALE
gaye	FEMALE
gayla	FEMALE
gayle	FEMALE
gaylene	FEMALE
gaylord	MALE
gaynell	FEMALE
gearldine	FEMALE
gemma	FEMALE
gena	FEMALE
genaro	MALE
gene	MALE
geneva	FEMALE
genevieve	FEMALE
genia	FEMALE
genie	FEMALE
gennie	FEMALE
genoveva	FEMALE
geoffrey	MALE
george	MALE
georgene	FEMALE
georgetta	FEMALE
georgette	FEMALE
georgia	FEMALE
georgiana	FEMALE
georgianna	FEMALE
georgie	FEMALE
georgina	FEMALE
georgine	FEMALE
gerald	MALE
geraldine	FEMALE
geraldo	MALE
geralyn	FEMALE
gerard	MALE
gerardo	MALE
gerda	FEMALE
geri	FEMALE
germaine	FEMALE
german	MALE
gerri	FEMALE
gerry	MALE
gertha	FEMALE
gertie	FEMALE
gertrud	FEMALE
gertrude	FEMALE
gia	FEMALE
gigi	FEMALE
gil	MALE
gilbert	MALE
gilberto	MALE
gilda	FEMALE
gillian	FEMALE
gina	FEMALE
ginger	FEMALE
ginny	FEMALE
gino	MALE
giovanna	FEMALE
giovanni	MALE
gisela	FEMALE
gisele	FEMALE
giselle	FEMALE
giuseppe	MALE
gladis	FEMALE
glady	FEMALE
gladys	FEMALE
glen	MALE
glenda	FEMALE
glendora	FEMALE
glenn	MALE
glenna	FEMALE
glennie	FEMALE
glennis	FEMALE
glinda	FEMALE
gloria	FEMALE
glory	FEMALE
glynda	FEMALE
golda	FEMALE
goldie	FEMALE
gonzalo	MALE
gordon	MALE
grace	FEMALE
gracia	FEMALE
gracie	FEMALE
graciela	FEMALE
grady	MALE
graham	MALE
graig	MALE
grant	MALE
granville	MALE
greg	MALE
gregg	MALE
gregoria	FEMALE
gregorio	MALE
gregory	MALE
greta	FEMALE
gretchen	FEMALE
gretta	FEMALE
griselda	FEMALE
grover	MALE
guadalupe	FEMALE
gudrun	FEMALE
guillermina	FEMALE
guillermo	MALE
gus	MALE
gussie	FEMALE
gustavo	MALE
guy	MALE
gwen	FEMALE
gwenda	FEMALE
gwendolyn	FEMALE
gwenn	FEMALE
ha	FEMALE
hae	FEMALE
hai	MALE
hailey	FEMALE
hal	MALE
haley	FEMALE
halina	FEMALE
hallie	FEMALE
hana	FEMALE
hanh	FEMALE
hank	MALE
hanna	FEMALE
hannah	FEMALE
hannelore	FEMALE
hans	MALE
harlan	MALE
harland	MALE
harley	MALE
harmony	FEMALE
harold	MALE
harriet	FEMALE
harriett	FEMALE
harriette	FEMALE
harris	MALE
harrison	MALE
harry	MALE
harvey	MALE
hassan	MALE
hattie	FEMALE
haydee	FEMALE
hayden	MALE
hayley	FEMALE
haywood	MALE
hazel	FEMALE
heath	MALE
heather	FEMALE
hector	MALE
hedwig	FEMALE
hedy	FEMALE
hee	FEMALE
heide	FEMALE
heidi	FEMALE
helen	FEMALE
helena	FEMALE
helene	FEMALE
helga	FEMALE
hellen	FEMALE
henrietta	FEMALE
henriette	FEMALE
henry	MALE
herb	MALE
herbert	MALE
heriberto	MALE
herlinda	FEMALE
herman	MALE
hermelinda	FEMALE
hermina	FEMALE
hermine	FEMALE
herminia	FEMALE
herschel	MALE
hershel	MALE
hester	FEMALE
hettie	FEMALE
hilaria	FEMALE
hilario	MALE
hilary	FEMALE
hilda	FEMALE
hilde	FEMALE
hildegard	FEMALE
hildegarde	FEMALE
hildred	FEMALE
hillary	FEMALE
hilma	FEMALE
hilton	MALE
hipolito	MALE
hiram	MALE
hiroko	FEMALE
hoa	FEMALE
hobert	MALE
holley	FEMALE
holli	FEMALE
hollie	FEMALE
hollis	FEMALE
hollis	MALE
holly	FEMALE
homer	MALE
honey	FEMALE
hong	FEMALE
hong	MALE
hope	FEMALE
horace	MALE
horacio	MALE
hortencia	FEMALE
hortense	FEMALE
hortensia	FEMALE
hosea	MALE
houston	MALE
howard	MALE
hoyt	MALE
hubert	MALE
huey	MALE
hugh	MALE
hugo	MALE
hui	FEMALE
hulda	FEMALE
humberto	MALE
hung	MALE
hunter	MALE
huong	FEMALE
hyacinth	FEMALE
hye	FEMALE
hyman	MALE
hyon	FEMALE
hyun	FEMALE
ian	MALE
ida	FEMALE
idalia	FEMALE
idell	FEMALE
idella	FEMALE
iesha	FEMALE
ignacia	FEMALE
ignacio	MALE
ike	MALE
ila	FEMALE
ilana	FEMALE
ilda	FEMALE
ileana	FEMALE
ilene	FEMALE
iliana	FEMALE
ilona	FEMALE
ilse	FEMALE
iluminada	FEMALE
ima	FEMALE
imelda	FEMALE
imogene	FEMALE
in	FEMALE
ina	FEMALE
india	FEMALE
indira	FEMALE
inell	FEMALE
ines	FEMALE
inez	FEMALE
inga	FEMALE
inge	FEMALE
ingeborg	FEMALE
inger	FEMALE
ingrid	FEMALE
iola	FEMALE
iona	FEMALE
ione	FEMALE
ira	MALE
irena	FEMALE
irene	FEMALE
irina	FEMALE
iris	FEMALE
irish	FEMALE
irma	FEMALE
irmgard	FEMALE
irvin	MALE
irving	MALE
irwin	MALE
isaac	MALE
isabel	FEMALE
isabell	FEMALE
isabella	FEMALE
isabelle	FEMALE
isaiah	MALE
isaias	MALE
isaura	FEMALE
isela	FEMALE
isiah	MALE
isidro	MALE
isis	FEMALE
ismael	MALE
israel	MALE
isreal	MALE
issac	MALE
iva	FEMALE
ivan	MALE
ivana	FEMALE
ivette	FEMALE
ivonne	FEMALE
ivory	FEMALE
ivy	FEMALE
jacalyn	FEMALE
jacinta	FEMALE
jacinto	MALE
jack	MALE
jackeline	FEMALE
jacki	FEMALE
jackie	FEMALE
jacklyn	FEMALE
jackson	MALE
jaclyn	FEMALE
jacob	MALE
jacqualine	FEMALE
jacque	FEMALE
jacquelin	FEMALE
jacqueline	FEMALE
jacquelyn	FEMALE
jacquelyne	FEMALE
jacquelynn	FEMALE
jacques	MALE
jacquiline	FEMALE
jacquline	FEMALE
jacqulyn	FEMALE
jada	FEMALE
jade	FEMALE
jadwiga	FEMALE
jae	FEMALE
jae	MALE
jaime	FEMALE
jaime	MALE
jaimie	FEMALE
jake	MALE
jaleesa	FEMALE
jamaal	MALE
jamal	MALE
jamar	MALE
jame	MALE
jamel	MALE
james	MALE
jamey	FEMALE
jamey	MALE
jami	FEMALE
jamie	FEMALE
jamie	MALE
jamila	FEMALE
jamison	MALE
jammie	FEMALE
jana	FEMALE
janae	FEMALE
janay	FEMALE
jane	FEMALE
janeen	FEMALE
janel	FEMALE
janell	FEMALE
janelle	FEMALE
janene	FEMALE
janessa	FEMALE
janet	FEMALE
janeth	FEMALE
janett	FEMALE
janetta	FEMALE
janette	FEMALE
janey	FEMALE
janice	FEMALE
janie	FEMALE
janina	FEMALE
janine	FEMALE
janis	FEMALE
janita	FEMALE
jann	FEMALE
janna	FEMALE
jannette	FEMALE
jannie	FEMALE
jaqueline	FEMALE
jared	MALE
jarod	MALE
jarred	MALE
jarrett	MALE
jarrod	MALE
jarvis	MALE
jasmin	FEMALE
jasmine	FEMALE
jason	MALE
jasper	MALE
jaunita	FEMALE
javier	MALE
jay	MALE
jayme	FEMALE
jayne	FEMALE
jayson	MALE
jazmin	FEMALE
jazmine	FEMALE
jc	MALE
jeana	FEMALE
jeane	FEMALE
jeanene	FEMALE
jeanetta	FEMALE
jeanette	FEMALE
jeanie	FEMALE
jeanine	FEMALE
jeanna	FEMALE
jeanne	FEMALE
jeannette	FEMALE
jeannie	FEMALE
jeannine	FEMALE
jed	MALE
jeff	MALE
jefferey	MALE
jefferson	MALE
jeffery	MALE
jeffrey	MALE
jeffry	MALE
jen	FEMALE
jena	FEMALE
jenell	FEMALE
jenelle	FEMALE
jenette	FEMALE
jeni	FEMALE
jenice	FEMALE
jenifer	FEMALE
jeniffer	FEMALE
jenine	FEMALE
jenise	FEMALE
jenna	FEMALE
jennefer	FEMALE
jennette	FEMALE
jenni	FEMALE
jennie	FEMALE
jennifer	FEMALE
jenniffer	FEMALE
jenny	FEMALE
jerald	MALE
jeraldine	FEMALE
jeramy	MALE
jere	MALE
jeremiah	MALE
jeremy	MALE
jeri	FEMALE
jerilyn	FEMALE
jermaine	MALE
jerold	MALE
jerome	MALE
jeromy	MALE
jerrell	MALE
jerri	FEMALE
jerrie	FEMALE
jerrod	MALE
jerrold	MALE
jerry	MALE
jesenia	FEMALE
jesica	FEMALE
jess	MALE
jesse	MALE
jessenia	FEMALE
jessi	FEMALE
jessica	FEMALE
jessie	FEMALE
jessie	MALE
jesus	MALE
jesusa	FEMALE
jettie	FEMALE
jewel	FEMALE
jewell	FEMALE
jill	FEMALE
jillian	FEMALE
jim	MALE
jimmie	MALE
jimmy	MALE
jin	FEMALE
jina	FEMALE
jo	FEMALE
joan	FEMALE
joana	FEMALE
joanie	FEMALE
joann	FEMALE
joanna	FEMALE
joanne	FEMALE
joaquin	MALE
jocelyn	FEMALE
jodee	FEMALE
jodi	FEMALE
jodie	FEMALE
jody	FEMALE
joe	MALE
joeann	FEMALE
joel	MALE
joella	FEMALE
joelle	FEMALE
joellen	FEMALE
joesph	MALE
joetta	FEMALE
joey	MALE
johana	FEMALE
johanna	FEMALE
john	MALE
johnathan	MALE
johnathon	MALE
johnetta	FEMALE
johnie	MALE
johnna	FEMALE
johnnie	MALE
johnny	MALE
johnson	MALE
joi	FEMALE
jolanda	FEMALE
joleen	FEMALE
jolene	FEMALE
jolie	FEMALE
jolynn	FEMALE
jon	MALE
jona	FEMALE
jonah	MALE
jonas	MALE
jonathan	MALE
jonathon	MALE
jonell	FEMALE
jonelle	FEMALE
joni	FEMALE
jonna	FEMALE
jonnie	FEMALE
jordan	FEMALE
jordan	MALE
jordon	MALE
jorge	MALE
jose	MALE
josef	MALE
josefa	FEMALE
josefina	FEMALE
joselyn	FEMALE
joseph	MALE
josephina	FEMALE
josephine	FEMALE
josette	FEMALE
josh	MALE
joshua	MALE
josiah	MALE
josie	FEMALE
joslyn	FEMALE
jospeh	MALE
josue	MALE
jovita	FEMALE
joy	FEMALE
joyce	FEMALE
joycelyn	FEMALE
joye	FEMALE
juan	MALE
juana	FEMALE
juanita	FEMALE
jude	MALE
judi	FEMALE
judie	FEMALE
judith	FEMALE
judson	MALE
judy	FEMALE
julee	FEMALE
jules	MALE
juli	FEMALE
julia	FEMALE
julian	MALE
juliana	FEMALE
juliane	FEMALE
juliann	FEMALE
julianna	FEMALE
julianne	FEMALE
julie	FEMALE
julienne	FEMALE
juliet	FEMALE
julieta	FEMALE
juliette	FEMALE
julio	MALE
julissa	FEMALE
julius	MALE
june	FEMALE
jung	FEMALE
junior	MALE
junita	FEMALE
justin	MALE
justina	FEMALE
justine	FEMALE
jutta	FEMALE
kacey	FEMALE
kaci	FEMALE
kacie	FEMALE
kacy	FEMALE
kaitlin	FEMALE
kaitlyn	FEMALE
kala	FEMALE
kaley	FEMALE
kali	FEMALE
kam	FEMALE
kami	FEMALE
kandace	FEMALE
kandi	FEMALE
kandice	FEMALE
kandy	FEMALE
kara	FEMALE
karan	FEMALE
kareem	MALE
karen	FEMALE
karey	FEMALE
kari	FEMALE
karie	FEMALE
karin	FEMALE
karina	FEMALE
karine	FEMALE
karissa	FEMALE
karl	MALE
karla	FEMALE
karleen	FEMALE
karlene	FEMALE
karma	FEMALE
karmen	FEMALE
karol	FEMALE
karolyn	FEMALE
karon	FEMALE
karren	FEMALE
karri	FEMALE
karrie	FEMALE
karyl	FEMALE
karyn	FEMALE
kasandra	FEMALE
kasey	FEMALE
kasey	MALE
kasie	FEMALE
kassandra	FEMALE
kassie	FEMALE
kate	FEMALE
katelyn	FEMALE
kathaleen	FEMALE
katharina	FEMALE
katharine	FEMALE
kathe	FEMALE
katherin	FEMALE
katherine	FEMALE
kathern	FEMALE
katheryn	FEMALE
kathey	FEMALE
kathi	FEMALE
kathie	FEMALE
kathleen	FEMALE
kathlene	FEMALE
kathlyn	FEMALE
kathrine	FEMALE
kathryn	FEMALE
kathryne	FEMALE
kathy	FEMALE
kathyrn	FEMALE
kati	FEMALE
katia	FEMALE
katie	FEMALE
katina	FEMALE
katlyn	FEMALE
katrice	FEMALE
katrina	FEMALE
kattie	FEMALE
katy	FEMALE
kay	FEMALE
kaye	FEMALE
kayla	FEMALE
kaylee	FEMALE
kayleen	FEMALE
kayleigh	FEMALE
kaylene	FEMALE
kazuko	FEMALE
kecia	FEMALE
keely	FEMALE
keena	FEMALE
keenan	MALE
keesha	FEMALE
keiko	FEMALE
keisha	FEMALE
keith	MALE
keli	FEMALE
kellee	FEMALE
kelley	FEMALE
kelley	MALE
kelli	FEMALE
kellie	FEMALE
kelly	FEMALE
kellye	FEMALE
kelsey	FEMALE
kelsie	FEMALE
kelvin	MALE
ken	MALE
kena	FEMALE
kendall	MALE
kendra	FEMALE
kendrick	MALE
keneth	MALE
kenisha	FEMALE
kenna	FEMALE
kenneth	MALE
kennith	MALE
kenny	MALE
kent	MALE
kenton	MALE
kenya	FEMALE
kenyatta	FEMALE
kenyetta	FEMALE
keri	FEMALE
kermit	MALE
kerri	FEMALE
kerrie	FEMALE
kerry	FEMALE
kerry	MALE
kesha	FEMALE
keshia	FEMALE
keven	MALE
kevin	MALE
kia	FEMALE
kiana	FEMALE
kiara	FEMALE
kiera	FEMALE
kiesha	FEMALE
kieth	MALE
kiley	FEMALE
kim	FEMALE
kimber	FEMALE
kimberely	FEMALE
kimberlee	FEMALE
kimberley	FEMALE
kimberli	FEMALE
kimberlie	FEMALE
kimberly	FEMALE
kimbery	FEMALE
kimiko	FEMALE
kindra	FEMALE
king	MALE
kip	MALE
kira	FEMALE
kirby	FEMALE
kirby	MALE
kirk	MALE
kirsten	FEMALE
kirstin	FEMALE
kisha	FEMALE
kitty	FEMALE
kizzy	FEMALE
korey	MALE
kori	FEMALE
kory	MALE
kourtney	FEMALE
kraig	MALE
kris	FEMALE
krista	FEMALE
kristal	FEMALE
kristan	FEMALE
kristel	FEMALE
kristen	FEMALE
kristi	FEMALE
kristian	FEMALE
kristie	FEMALE
kristin	FEMALE
kristina	FEMALE
kristine	FEMALE
kristofer	MALE
kristopher	MALE
kristy	FEMALE
kristyn	FEMALE
krysta	FEMALE
krystal	FEMALE
krystle	FEMALE
krystyna	FEMALE
kum	FEMALE
kurt	MALE
kurtis	MALE
kyla	FEMALE
kyle	MALE
kylee	FEMALE
kylie	FEMALE
kym	FEMALE
kymberly	FEMALE
kyong	FEMALE
kyra	FEMALE
kyung	FEMALE
lacey	FEMALE
laci	FEMALE
lacie	FEMALE
lacy	FEMALE
ladonna	FEMALE
lady	FEMALE
lai	FEMALE
laila	FEMALE
lakeisha	FEMALE
lakesha	FEMALE
lakeshia	FEMALE
lakisha	FEMALE
lamar	MALE
lamont	MALE
lan	FEMALE
lana	FEMALE
lance	MALE
landon	MALE
lane	MALE
lanell	FEMALE
lanette	FEMALE
lani	FEMALE
lanita	FEMALE
lanny	MALE
laquita	FEMALE
lara	FEMALE
larae	FEMALE
laraine	FEMALE
larhonda	FEMALE
larisa	FEMALE
larissa	FEMALE
laronda	FEMALE
larry	MALE
larue	FEMALE
lashanda	FEMALE
lashawn	FEMALE
lashonda	FEMALE
lashunda	FEMALE
latanya	FEMALE
latasha	FEMALE
latesha	FEMALE
latia	FEMALE
laticia	FEMALE
latisha	FEMALE
latonia	FEMALE
latonya	FEMALE
latoria	FEMALE
latosha	FEMALE
latoya	FEMALE
latrice	FEMALE
latricia	FEMALE
latrina	FEMALE
launa	FEMALE
laura	FEMALE
laure	FEMALE
laureen	FEMALE
laurel	FEMALE
lauren	FEMALE
laurence	MALE
laurene	FEMALE
lauretta	FEMALE
laurette	FEMALE
lauri	FEMALE
laurice	FEMALE
laurie	FEMALE
laurine	FEMALE
lavada	FEMALE
lavera	FEMALE
lavern	FEMALE
laverna	FEMALE
laverne	FEMALE
lavina	FEMALE
lavinia	FEMALE
lavon	FEMALE
lavonda	FEMALE
lavonia	FEMALE
lavonne	FEMALE
lawana	FEMALE
lawanda	FEMALE
lawanna	FEMALE
lawerence	MALE
lawrence	MALE
layla	FEMALE
lazaro	MALE
le	FEMALE
lea	FEMALE
leah	FEMALE
leana	FEMALE
leandra	FEMALE
leandro	MALE
leann	FEMALE
leanna	FEMALE
leanne	FEMALE
leatha	FEMALE
leatrice	FEMALE
leda	FEMALE
lee	MALE
leeann	FEMALE
leeanna	FEMALE
leeanne	FEMALE
leesa	FEMALE
leif	MALE
leigh	FEMALE
leighann	FEMALE
leila	FEMALE
leilani	FEMALE
leisa	FEMALE
lela	FEMALE
leland	MALE
lelia	FEMALE
lemuel	MALE
len	MALE
lena	FEMALE
lenard	MALE
lenna	FEMALE
lennie	FEMALE
lenny	MALE
lenora	FEMALE
lenore	FEMALE
leo	MALE
leola	FEMALE
leon	MALE
leona	FEMALE
leonard	MALE
leonarda	FEMALE
leonardo	MALE
leone	FEMALE
leonel	MALE
leonie	FEMALE
leonila	FEMALE
leonor	FEMALE
leonora	FEMALE
leonore	FEMALE
leopoldo	MALE
leora	FEMALE
leota	FEMALE
lera	FEMALE
leroy	MALE
les	MALE
lesa	FEMALE
lesia	FEMALE
leslee	FEMALE
lesley	FEMALE
lesley	MALE
lesli	FEMALE
leslie	FEMALE
lessie	FEMALE
lester	MALE
leta	FEMALE
letha	FEMALE
leticia	FEMALE
letitia	FEMALE
lettie	FEMALE
letty	FEMALE
levi	MALE
lewis	MALE
li	FEMALE
lia	FEMALE
liana	FEMALE
liane	FEMALE
libby	FEMALE
liberty	FEMALE
lida	FEMALE
lidia	FEMALE
lien	FEMALE
ligia	FEMALE
lila	FEMALE
lili	FEMALE
lilia	FEMALE
lilian	FEMALE
liliana	FEMALE
lilla	FEMALE
lillian	FEMALE
lillie	FEMALE
lilly	FEMALE
lily	FEMALE
lin	FEMALE
lina	FEMALE
lincoln	MALE
linda	FEMALE
lindsay	FEMALE
lindsey	FEMALE
lindy	FEMALE
linette	FEMALE
ling	FEMALE
linh	FEMALE
linnea	FEMALE
linnie	FEMALE
lino	MALE
linsey	FEMALE
linwood	MALE
lionel	MALE
lisa	FEMALE
lisbeth	FEMALE
lise	FEMALE
lisette	FEMALE
lisha	FEMALE
lissa	FEMALE
lissette	FEMALE
lita	FEMALE
livia	FEMALE
liz	FEMALE
liza	FEMALE
lizabeth	FEMALE
lizbeth	FEMALE
lizette	FEMALE
lizzie	FEMALE
lloyd	MALE
loan	FEMALE
logan	MALE
loida	FEMALE
lois	FEMALE
lola	FEMALE
lolita	FEMALE
loma	FEMALE
lon	MALE
lona	FEMALE
long	MALE
loni	FEMALE
lonna	FEMALE
lonnie	FEMALE
lonnie	MALE
lonny	MALE
lora	FEMALE
loraine	FEMALE
lore	FEMALE
loree	FEMALE
loreen	FEMALE
lorelei	FEMALE
loren	FEMALE
lorena	FEMALE
lorene	FEMALE
lorenza	FEMALE
lorenzo	MALE
loretta	FEMALE
lori	FEMALE
loriann	FEMALE
lorie	FEMALE
lorinda	FEMALE
lorine	FEMALE
lorna	FEMALE
lorraine	FEMALE
lorretta	FEMALE
lorri	FEMALE
lorrie	FEMALE
lory	FEMALE
lottie	FEMALE
lou	MALE
louann	FEMALE
louanne	FEMALE
louella	FEMALE
louie	MALE
louis	MALE
louisa	FEMALE
louise	FEMALE
lourdes	FEMALE
louvenia	FEMALE
lovella	FEMALE
lovie	FEMALE
lowell	MALE
loyce	FEMALE
loyd	MALE
lu	FEMALE
luana	FEMALE
luann	FEMALE
luanne	FEMALE
lucas	MALE
lucia	FEMALE
luciana	FEMALE
luciano	MALE
lucie	FEMALE
lucien	MALE
lucienne	FEMALE
lucila	FEMALE
lucile	FEMALE
lucille	FEMALE
lucina	FEMALE
lucinda	FEMALE
lucio	MALE
lucius	MALE
lucrecia	FEMALE
lucretia	FEMALE
lucy	FEMALE
ludie	FEMALE
lue	FEMALE
luella	FEMALE
luigi	MALE
luis	MALE
luisa	FEMALE
luise	FEMALE
luke	MALE
lula	FEMALE
lulu	FEMALE
luna	FEMALE
lupe	FEMALE
lupita	FEMALE
lura	FEMALE
lurline	FEMALE
luther	MALE
luvenia	FEMALE
luz	FEMALE
lyda	FEMALE
lydia	FEMALE
lyla	FEMALE
lyle	MALE
lyman	MALE
lyn	FEMALE
lynda	FEMALE
lyndon	MALE
lyndsay	FEMALE
lyndsey	FEMALE
lynell	FEMALE
lynelle	FEMALE
lynette	FEMALE
lynn	FEMALE
lynne	FEMALE
lynnette	FEMALE
lynsey	FEMALE
lynwood	MALE
ma	FEMALE
mabel	FEMALE
mable	FEMALE
mac	MALE
machelle	FEMALE
macie	FEMALE
mack	MALE
mackenzie	FEMALE
macy	FEMALE
madaline	FEMALE
madalyn	FEMALE
madeleine	FEMALE
madeline	FEMALE
madelyn	FEMALE
madge	FEMALE
madie	FEMALE
madison	FEMALE
madlyn	FEMALE
madonna	FEMALE
mae	FEMALE
maegan	FEMALE
magaly	FEMALE
magan	FEMALE
magaret	FEMALE
magda	FEMALE
magdalena	FEMALE
magdalene	FEMALE
magen	FEMALE
maggie	FEMALE
magnolia	FEMALE
mai	FEMALE
maia	FEMALE
maida	FEMALE
maira	FEMALE
major	MALE
majorie	FEMALE
malcolm	MALE
malcom	MALE
malia	FEMALE
malik	MALE
malika	FEMALE
malinda	FEMALE
malisa	FEMALE
malissa	FEMALE
mallory	FEMALE
mamie	FEMALE
mammie	FEMALE
man	MALE
manda	FEMALE
mandi	FEMALE
mandy	FEMALE
manual	MALE
manuel	MALE
manuela	FEMALE
maple	FEMALE
mara	FEMALE
maranda	FEMALE
marc	MALE
marcel	MALE
marcela	FEMALE
marcelina	FEMALE
marcelino	MALE
marcella	FEMALE
marcelle	FEMALE
marcellus	MALE
marcelo	MALE
marci	FEMALE
marcia	FEMALE
marcie	FEMALE
marco	MALE
marcos	MALE
marcus	MALE
marcy	FEMALE
maren	FEMALE
margaret	FEMALE
margareta	FEMALE
margarete	FEMALE
margarett	FEMALE
margaretta	FEMALE
margarette	FEMALE
margarita	FEMALE
margarite	FEMALE
margarito	MALE
margart	FEMALE
marge	FEMALE
margeret	FEMALE
margery	FEMALE
margie	FEMALE
margit	FEMALE
margo	FEMALE
margorie	FEMALE
margot	FEMALE
margret	FEMALE
marguerita	FEMALE
marguerite	FEMALE
margurite	FEMALE
mari	FEMALE
maria	FEMALE
mariah	FEMALE
mariam	FEMALE
marian	FEMALE
mariana	FEMALE
mariann	FEMALE
marianna	FEMALE
marianne	FEMALE
mariano	MALE
maribel	FEMALE
maribeth	FEMALE
maricela	FEMALE
marie	FEMALE
mariel	FEMALE
mariela	FEMALE
marietta	FEMALE
marilee	FEMALE
marilou	FEMALE
marilu	FEMALE
marilyn	FEMALE
marilynn	FEMALE
marina	FEMALE
mario	MALE
marion	FEMALE
marisa	FEMALE
marisela	FEMALE
marisol	FEMALE
marissa	FEMALE
marita	FEMALE
maritza	FEMALE
marjorie	FEMALE
marjory	FEMALE
mark	MALE
markita	FEMALE
markus	MALE
marla	FEMALE
marlana	FEMALE
marleen	FEMALE
marlena	FEMALE
marlene	FEMALE
marlin	MALE
marlo	FEMALE
marlon	MALE
marlyn	FEMALE
marlys	FEMALE
marna	FEMALE
marni	FEMALE
marnie	FEMALE
marquerite	FEMALE
marquetta	FEMALE
marquis	MALE
marquita	FEMALE
marry	FEMALE
marsha	FEMALE
marshall	MALE
marta	FEMALE
martha	FEMALE
marti	FEMALE
martin	MALE
martina	FEMALE
martine	FEMALE
marty	MALE
marva	FEMALE
marvel	FEMALE
marvin	MALE
mary	FEMALE
marya	FEMALE
maryalice	FEMALE
maryam	FEMALE
maryann	FEMALE
maryanne	FEMALE
marybeth	FEMALE
maryellen	FEMALE
maryjane	FEMALE
maryjo	FEMALE
marylee	FEMALE
marylin	FEMALE
marylou	FEMALE
marylyn	FEMALE
masako	FEMALE
mason	MALE
mathew	MALE
mathilda	FEMALE
mathilde	FEMALE
matilda	FEMALE
matilde	FEMALE
matt	MALE
matthew	MALE
mattie	FEMALE
maud	FEMALE
maude	FEMALE
maudie	FEMALE
maura	FEMALE
maureen	FEMALE
maurice	MALE
mauricio	MALE
maurine	FEMALE
mauro	MALE
mavis	FEMALE
max	MALE
maxie	FEMALE
maximo	MALE
maxine	FEMALE
maxwell	MALE
may	FEMALE
maya	FEMALE
maybell	FEMALE
maybelle	FEMALE
maye	FEMALE
mayme	FEMALE
maynard	MALE
mayra	FEMALE
mazie	FEMALE
mckenzie	FEMALE
mckinley	MALE
meagan	FEMALE
meaghan	FEMALE
mechelle	FEMALE
mee	FEMALE
meg	FEMALE
megan	FEMALE
meghan	FEMALE
meghann	FEMALE
mei	FEMALE
mel	MALE
melanie	FEMALE
melany	FEMALE
melba	FEMALE
melina	FEMALE
melinda	FEMALE
melisa	FEMALE
melissa	FEMALE
melissia	FEMALE
mellie	FEMALE
mellisa	FEMALE
mellissa	FEMALE
melodie	FEMALE
melody	FEMALE
melonie	FEMALE
melony	FEMALE
melva	FEMALE
melvin	MALE
melvina	FEMALE
melynda	FEMALE
mercedes	FEMALE
mercy	FEMALE
meredith	FEMALE
meri	FEMALE
meridith	FEMALE
merilyn	FEMALE
merle	FEMALE
merle	MALE
merlene	FEMALE
merlin	MALE
merna	FEMALE
merri	FEMALE
merrill	MALE
merry	FEMALE
mervin	MALE
meryl	FEMALE
meta	FEMALE
mi	FEMALE
mia	FEMALE
micaela	FEMALE
micah	MALE
michael	MALE
michaela	FEMALE
michal	FEMALE
michal	MALE
michale	MALE
micheal	MALE
michel	MALE
micheline	FEMALE
michell	FEMALE
michelle	FEMALE
michiko	FEMALE
mickey	MALE
micki	FEMALE
mickie	FEMALE
migdalia	FEMALE
miguel	MALE
miguelina	FEMALE
mike	MALE
mikel	MALE
mikki	FEMALE
mila	FEMALE
milagro	FEMALE
milagros	FEMALE
milan	MALE
mildred	FEMALE
miles	MALE
milford	MALE
milissa	FEMALE
millard	MALE
millicent	FEMALE
millie	FEMALE
milo	MALE
milton	MALE
mimi	FEMALE
min	FEMALE
mina	FEMALE
mindi	FEMALE
mindy	FEMALE
minerva	FEMALE
minh	FEMALE
minh	MALE
minna	FEMALE
minnie	FEMALE
miquel	MALE
mira	FEMALE
miranda	FEMALE
mireille	FEMALE
mireya	FEMALE
miriam	FEMALE
mirian	FEMALE
mirna	FEMALE
mirta	FEMALE
mirtha	FEMALE
missy	FEMALE
misti	FEMALE
misty	FEMALE
mitch	MALE
mitchel	MALE
mitchell	MALE
mittie	FEMALE
mitzi	FEMALE
modesta	FEMALE
modesto	MALE
mohamed	MALE
mohammad	MALE
mohammed	MALE
moira	FEMALE
moises	MALE
mollie	FEMALE
molly	FEMALE
mona	FEMALE
monica	FEMALE
monika	FEMALE
monique	FEMALE
monroe	MALE
monserrate	FEMALE
monte	MALE
monty	MALE
morgan	FEMALE
morgan	MALE
morris	MALE
morton	MALE
mose	MALE
moses	MALE
moshe	MALE
mozell	FEMALE
mozella	FEMALE
mozelle	FEMALE
mui	FEMALE
muriel	FEMALE
murray	MALE
my	FEMALE
myles	MALE
myong	FEMALE
myra	FEMALE
myriam	FEMALE
myrle	FEMALE
myrna	FEMALE
myron	MALE
myrtice	FEMALE
myrtie	FEMALE
myrtis	FEMALE
myrtle	FEMALE
myung	FEMALE
nada	FEMALE
nadia	FEMALE
nadine	FEMALE
nakia	FEMALE
nakisha	FEMALE
nakita	FEMALE
nan	FEMALE
nana	FEMALE
nanci	FEMALE
nancie	FEMALE
nancy	FEMALE
nanette	FEMALE
nannette	FEMALE
nannie	FEMALE
naoma	FEMALE
naomi	FEMALE
napoleon	MALE
narcisa	FEMALE
natalia	FEMALE
natalie	FEMALE
natasha	FEMALE
nathalie	FEMALE
nathan	MALE
nathanael	MALE
nathanial	MALE
nathaniel	MALE
natividad	FEMALE
natosha	FEMALE
neal	MALE
ned	MALE
nedra	FEMALE
neil	MALE
nelda	FEMALE
nelia	FEMALE
nelida	FEMALE
nell	FEMALE
nella	FEMALE
nelle	FEMALE
nellie	FEMALE
nelly	FEMALE
nelson	MALE
nena	FEMALE
neoma	FEMALE
nereida	FEMALE
nerissa	FEMALE
nestor	MALE
neta	FEMALE
nettie	FEMALE
neva	FEMALE
neville	MALE
newton	MALE
nga	FEMALE
ngoc	FEMALE
nia	FEMALE
nichelle	FEMALE
nichol	FEMALE
nicholas	MALE
nichole	FEMALE
nick	MALE
nicki	FEMALE
nickie	FEMALE
nickolas	MALE
nickole	FEMALE
nicky	FEMALE
nicol	FEMALE
nicola	FEMALE
nicolas	MALE
nicolasa	FEMALE
nicole	FEMALE
nicolette	FEMALE
nicolle	FEMALE
nidia	FEMALE
nieves	FEMALE
nigel	MALE
niki	FEMALE
nikia	FEMALE
nikita	FEMALE
nikki	FEMALE
nikole	FEMALE
nila	FEMALE
nilda	FEMALE
nilsa	FEMALE
nina	FEMALE
ninfa	FEMALE
nita	FEMALE
noah	MALE
noble	MALE
noe	MALE
noel	MALE
noelia	FEMALE
noella	FEMALE
noelle	FEMALE
noemi	FEMALE
nola	FEMALE
nolan	MALE
noma	FEMALE
nona	FEMALE
nora	FEMALE
norah	FEMALE
norbert	MALE
norberto	MALE
noreen	FEMALE
norene	FEMALE
norine	FEMALE
norma	FEMALE
norman	MALE
normand	MALE
norris	MALE
nova	FEMALE
novella	FEMALE
numbers	MALE
nydia	FEMALE
nyla	FEMALE
ocie	FEMALE
octavia	FEMALE
octavio	MALE
odell	FEMALE
odell	MALE
odessa	FEMALE
odette	FEMALE
odilia	FEMALE
odis	MALE
ofelia	FEMALE
ok	FEMALE
ola	FEMALE
olen	MALE
oleta	FEMALE
olga	FEMALE
olin	MALE
oliva	FEMALE
olive	FEMALE
oliver	MALE
olivia	FEMALE
ollie	FEMALE
ollie	MALE
olympia	FEMALE
oma	FEMALE
omar	MALE
omer	MALE
ona	FEMALE
oneida	FEMALE
opal	FEMALE
ophelia	FEMALE
ora	FEMALE
oralia	FEMALE
oren	MALE
orlando	MALE
orpha	FEMALE
orval	MALE
orville	MALE
oscar	MALE
ossie	FEMALE
osvaldo	MALE
oswaldo	MALE
otha	MALE
otilia	FEMALE
otis	MALE
otto	MALE
ouida	FEMALE
owen	MALE
ozella	FEMALE
pablo	MALE
page	FEMALE
paige	FEMALE
palma	FEMALE
palmer	MALE
pam	FEMALE
pamala	FEMALE
pamela	FEMALE
pamelia	FEMALE
pamella	FEMALE
pandora	FEMALE
pansy	FEMALE
paola	FEMALE
paris	FEMALE
paris	MALE
parker	MALE
particia	FEMALE
pasquale	MALE
pat	FEMALE
pat	MALE
patience	FEMALE
patrica	FEMALE
patrice	FEMALE
patricia	FEMALE
patrick	MALE
patrina	FEMALE
patsy	FEMALE
patti	FEMALE
pattie	FEMALE
patty	FEMALE
paul	MALE
paula	FEMALE
pauletta	FEMALE
paulette	FEMALE
paulina	FEMALE
pauline	FEMALE
pearl	FEMALE
pearle	FEMALE
pearlene	FEMALE
pearlie	FEMALE
pearline	FEMALE
pedro	MALE
peggie	FEMALE
peggy	FEMALE
penelope	FEMALE
penney	FEMALE
penni	FEMALE
pennie	FEMALE
penny	FEMALE
percy	MALE
perla	FEMALE
perry	MALE
pete	MALE
peter	MALE
petra	FEMALE
petrina	FEMALE
phil	MALE
philip	MALE
phillip	MALE
phillis	FEMALE
philomena	FEMALE
phoebe	FEMALE
phuong	FEMALE
phylis	FEMALE
phyliss	FEMALE
phyllis	FEMALE
pia	FEMALE
piedad	FEMALE
pierre	MALE
pilar	FEMALE
pinkie	FEMALE
piper	FEMALE
polly	FEMALE
porfirio	MALE
porsha	FEMALE
porter	MALE
portia	FEMALE
precious	FEMALE
preston	MALE
pricilla	FEMALE
prince	MALE
princess	FEMALE
priscilla	FEMALE
prudence	FEMALE
qiana	FEMALE
queen	FEMALE
queenie	FEMALE
quentin	MALE
quiana	FEMALE
quincy	MALE
quinn	MALE
quintin	MALE
quinton	MALE
rachael	FEMALE
racheal	FEMALE
rachel	FEMALE
rachele	FEMALE
rachell	FEMALE
rachelle	FEMALE
racquel	FEMALE
rae	FEMALE
raeann	FEMALE
rafael	MALE
rafaela	FEMALE
raina	FEMALE
raleigh	MALE
ralph	MALE
ramiro	MALE
ramon	MALE
ramona	FEMALE
ramonita	FEMALE
rana	FEMALE
ranae	FEMALE
randa	FEMALE
randal	MALE
randall	MALE
randee	FEMALE
randell	MALE
randi	FEMALE
randolph	MALE
randy	MALE
raphael	MALE
raquel	FEMALE
rashad	MALE
rashida	FEMALE
raul	MALE
raven	FEMALE
ray	MALE
raye	FEMALE
rayford	MALE
raylene	FEMALE
raymon	MALE
raymond	MALE
raymundo	MALE
rayna	FEMALE
reatha	FEMALE
reba	FEMALE
rebbeca	FEMALE
rebbecca	FEMALE
rebeca	FEMALE
rebecca	FEMALE
rebekah	FEMALE
reda	FEMALE
reed	MALE
refugio	FEMALE
refugio	MALE
regan	FEMALE
regena	FEMALE
regenia	FEMALE
reggie	MALE
regina	FEMALE
reginald	MALE
reid	MALE
reina	FEMALE
reinaldo	MALE
remedios	FEMALE
rena	FEMALE
renae	FEMALE
renaldo	MALE
renata	FEMALE
renate	FEMALE
renato	MALE
rene	FEMALE
renea	FEMALE
renee	FEMALE
renita	FEMALE
reta	FEMALE
retha	FEMALE
retta	FEMALE
reuben	MALE
reva	FEMALE
rex	MALE
rey	MALE
reyes	MALE
reyna	FEMALE
reynaldo	MALE
rhea	FEMALE
rhett	MALE
rhiannon	FEMALE
rhoda	FEMALE
rhonda	FEMALE
ricardo	MALE
rich	MALE
richard	MALE
richelle	FEMALE
richie	MALE
rick	MALE
rickey	MALE
rickie	MALE
ricky	MALE
rico	MALE
rigoberto	MALE
rikki	FEMALE
riley	MALE
rina	FEMALE
risa	FEMALE
rita	FEMALE
rob	MALE
robbie	MALE
robbin	FEMALE
robby	MALE
robert	MALE
roberta	FEMALE
roberto	MALE
robin	FEMALE
robin	MALE
robt	MALE
robyn	FEMALE
rocco	MALE
rochell	FEMALE
rochelle	FEMALE
rocio	FEMALE
rocky	MALE
rod	MALE
roderick	MALE
rodger	MALE
rodney	MALE
rodolfo	MALE
rodrick	MALE
rodrigo	MALE
rogelio	MALE
roger	MALE
roland	MALE
rolanda	FEMALE
rolando	MALE
rolf	MALE
rolland	MALE
roma	FEMALE
romaine	FEMALE
roman	MALE
romana	FEMALE
romelia	FEMALE
romeo	MALE
romona	FEMALE
ron	MALE
rona	FEMALE
ronald	MALE
ronda	FEMALE
roni	FEMALE
ronna	FEMALE
ronni	FEMALE
ronnie	MALE
ronny	MALE
roosevelt	MALE
rory	MALE
rosa	FEMALE
rosalba	FEMALE
rosalee	FEMALE
rosalia	FEMALE
rosalie	FEMALE
rosalina	FEMALE
rosalind	FEMALE
rosalinda	FEMALE
rosaline	FEMALE
rosalva	FEMALE
rosalyn	FEMALE
rosamond	FEMALE
rosana	FEMALE
rosann	FEMALE
rosanna	FEMALE
rosanne	FEMALE
rosaria	FEMALE
rosario	MALE
rosaura	FEMALE
roscoe	MALE
rose	FEMALE
roseann	FEMALE
roseanna	FEMALE
roseanne	FEMALE
rosella	FEMALE
roselyn	FEMALE
rosemarie	FEMALE
rosemary	FEMALE
rosendo	MALE
rosetta	FEMALE
rosia	FEMALE
rosie	FEMALE
rosina	FEMALE
rosita	FEMALE
roslyn	FEMALE
ross	MALE
rowena	FEMALE
roxana	FEMALE
roxane	FEMALE
roxann	FEMALE
roxanna	FEMALE
roxanne	FEMALE
roxie	FEMALE
roy	MALE
royal	MALE
royce	MALE
rozella	FEMALE
ruben	MALE
rubie	FEMALE
rubin	MALE
ruby	FEMALE
rubye	FEMALE
rudolf	MALE
rudolph	MALE
rudy	MALE
rueben	MALE
rufina	FEMALE
rufus	MALE
rupert	MALE
russ	MALE
russel	MALE
russell	MALE
rusty	MALE
ruth	FEMALE
ruthann	FEMALE
ruthie	FEMALE
ryan	MALE
sabina	FEMALE
sabine	FEMALE
sabra	FEMALE
sabrina	FEMALE
sachiko	FEMALE
sade	FEMALE
sadie	FEMALE
sal	MALE
salena	FEMALE
salina	FEMALE
sallie	FEMALE
sally	FEMALE
salome	FEMALE
salvador	MALE
salvatore	MALE
sam	MALE
samantha	FEMALE
samara	FEMALE
samatha	FEMALE
samira	FEMALE
sammie	FEMALE
sammie	MALE
sammy	MALE
samual	MALE
samuel	MALE
sandi	FEMALE
sandra	FEMALE
sandy	FEMALE
sanford	MALE
sang	FEMALE
sang	MALE
sanjuana	FEMALE
sanjuanita	FEMALE
sanora	FEMALE
santa	FEMALE
santana	FEMALE
santiago	MALE
santina	FEMALE
santo	MALE
santos	MALE
sara	FEMALE
sarah	FEMALE
sari	FEMALE
sarina	FEMALE
sarita	FEMALE
sasha	FEMALE
saul	MALE
saundra	FEMALE
savanna	FEMALE
savannah	FEMALE
scarlet	FEMALE
scarlett	FEMALE
scot	MALE
scott	MALE
scottie	MALE
scotty	MALE
sean	MALE
sebastian	MALE
sebrina	FEMALE
selena	FEMALE
selene	FEMALE
selina	FEMALE
selma	FEMALE
serena	FEMALE
sergio	MALE
serina	FEMALE
seth	MALE
seymour	MALE
sha	FEMALE
shad	MALE
shaina	FEMALE
shakira	FEMALE
shalonda	FEMALE
shameka	FEMALE
shamika	FEMALE
shana	FEMALE
shanda	FEMALE
shandra	FEMALE
shane	MALE
shaneka	FEMALE
shanell	FEMALE
shanelle	FEMALE
shani	FEMALE
shanice	FEMALE
shanika	FEMALE
shanita	FEMALE
shanna	FEMALE
shannan	FEMALE
shannon	MALE
shanon	FEMALE
shanta	FEMALE
shante	FEMALE
shantel	FEMALE
shantell	FEMALE
shara	FEMALE
sharee	FEMALE
sharen	FEMALE
shari	FEMALE
sharita	FEMALE
sharla	FEMALE
sharleen	FEMALE
sharlene	FEMALE
sharon	FEMALE
sharonda	FEMALE
sharron	FEMALE
sharyl	FEMALE
sharyn	FEMALE
shasta	FEMALE
shaun	FEMALE
shaun	MALE
shauna	FEMALE
shaunna	FEMALE
shavon	FEMALE
shavonne	FEMALE
shawana	FEMALE
shawanda	FEMALE
shawn	FEMALE
shawn	MALE
shawna	FEMALE
shawnda	FEMALE
shawnee	FEMALE
shawnna	FEMALE
shay	FEMALE
shayla	FEMALE
shayna	FEMALE
shayne	MALE
shea	FEMALE
sheena	FEMALE
sheila	FEMALE
sheilah	FEMALE
shela	FEMALE
shelba	FEMALE
shelby	FEMALE
sheldon	MALE
shelia	FEMALE
shelley	FEMALE
shelli	FEMALE
shellie	FEMALE
shelly	FEMALE
shelton	MALE
shemika	FEMALE
shena	FEMALE
shenita	FEMALE
sheree	FEMALE
sheri	FEMALE
sherie	FEMALE
sherilyn	FEMALE
sherita	FEMALE
sherley	FEMALE
sherly	FEMALE
sherlyn	FEMALE
sherman	MALE
sheron	FEMALE
sherrell	FEMALE
sherri	FEMALE
sherrie	FEMALE
sherrill	FEMALE
sherron	FEMALE
sherry	FEMALE
sherryl	FEMALE
sherwood	MALE
sheryl	FEMALE
shiela	FEMALE
shira	FEMALE
shirlee	FEMALE
shirleen	FEMALE
shirlene	FEMALE
shirley	FEMALE
shirly	FEMALE
shon	MALE
shona	FEMALE
shonda	FEMALE
shonna	FEMALE
shoshana	FEMALE
shu	FEMALE
sibyl	FEMALE
sid	MALE
sidney	FEMALE
sierra	FEMALE
signe	FEMALE
sigrid	FEMALE
silas	MALE
silva	FEMALE
silvana	FEMALE
silvia	FEMALE
simon	MALE
simona	FEMALE
simone	FEMALE
sindy	FEMALE
siobhan	FEMALE
skye	FEMALE
slyvia	FEMALE
so	FEMALE
socorro	FEMALE
sofia	FEMALE
sol	MALE
solange	FEMALE
soledad	FEMALE
solomon	MALE
sommer	FEMALE
son	MALE
sondra	FEMALE
song	FEMALE
sonia	FEMALE
sonja	FEMALE
sonny	MALE
sonya	FEMALE
soo	FEMALE
sook	FEMALE
soon	FEMALE
sophia	FEMALE
sophie	FEMALE
soraya	FEMALE
spencer	MALE
spring	FEMALE
stacey	FEMALE
staci	FEMALE
stacia	FEMALE
stacie	FEMALE
stacy	FEMALE
stan	MALE
stanford	MALE
stanley	MALE
stanton	MALE
star	FEMALE
starla	FEMALE
starr	FEMALE
stefan	MALE
stefani	FEMALE
stefania	FEMALE
stefanie	FEMALE
steffanie	FEMALE
stella	FEMALE
stephaine	FEMALE
stephan	MALE
stephane	FEMALE
stephani	FEMALE
stephanie	FEMALE
stephany	FEMALE
stephen	MALE
stephenie	FEMALE
stephine	FEMALE
sterling	MALE
steve	MALE
steven	MALE
stevie	FEMALE
stewart	MALE
stormy	FEMALE
stuart	MALE
su	FEMALE
sudie	FEMALE
sue	FEMALE
sueann	FEMALE
suellen	FEMALE
suk	FEMALE
summer	FEMALE
sun	FEMALE
sung	FEMALE
sung	MALE
sunny	FEMALE
sunshine	FEMALE
susan	FEMALE
susana	FEMALE
susann	FEMALE
susanna	FEMALE
susannah	FEMALE
susanne	FEMALE
susie	FEMALE
suzan	FEMALE
suzann	FEMALE
suzanna	FEMALE
suzanne	FEMALE
suzette	FEMALE
suzie	FEMALE
suzy	FEMALE
sybil	FEMALE
syble	FEMALE
sydney	FEMALE
sylvester	MALE
sylvia	FEMALE
synthia	FEMALE
syreeta	FEMALE
tabatha	FEMALE
tabetha	FEMALE
tabitha	FEMALE
tad	MALE
takisha	FEMALE
talia	FEMALE
talisha	FEMALE
tam	FEMALE
tamala	FEMALE
tamar	FEMALE
tamara	FEMALE
tamatha	FEMALE
tameika	FEMALE
tameka	FEMALE
tamekia	FEMALE
tamela	FEMALE
tamera	FEMALE
tamesha	FEMALE
tami	FEMALE
tamica	FEMALE
tamie	FEMALE
tamika	FEMALE
tamiko	FEMALE
tammara	FEMALE
tammi	FEMALE
tammie	FEMALE
tammy	FEMALE
tamra	FEMALE
tana	FEMALE
tanesha	FEMALE
tangela	FEMALE
tania	FEMALE
tanika	FEMALE
tanisha	FEMALE
tanja	FEMALE
tanna	FEMALE
tanner	MALE
tanya	FEMALE
tara	FEMALE
tarah	FEMALE
tarsha	FEMALE
taryn	FEMALE
tasha	FEMALE
tatiana	FEMALE
tawana	FEMALE
tawanda	FEMALE
tawanna	FEMALE
tawny	FEMALE
tawnya	FEMALE
taylor	MALE
ted	MALE
teddy	MALE
teena	FEMALE
temeka	FEMALE
tena	FEMALE
tenisha	FEMALE
tennie	FEMALE
tennille	FEMALE
teodora	FEMALE
teodoro	MALE
tequila	FEMALE
tera	FEMALE
tereasa	FEMALE
terence	MALE
teresa	FEMALE
terese	FEMALE
teresita	FEMALE
teressa	FEMALE
teri	FEMALE
terra	FEMALE
terrance	MALE
terrell	MALE
terrence	MALE
terresa	FEMALE
terri	FEMALE
terrie	FEMALE
terry	FEMALE
terry	MALE
tesha	FEMALE
tess	FEMALE
tessa	FEMALE
tessie	FEMALE
thad	MALE
thaddeus	MALE
thalia	FEMALE
thanh	FEMALE
thanh	MALE
thao	FEMALE
thea	FEMALE
theda	FEMALE
thelma	FEMALE
theo	MALE
theodora	FEMALE
theodore	MALE
theresa	FEMALE
therese	FEMALE
theresia	FEMALE
theron	MALE
thersa	FEMALE
thomas	MALE
thomasina	FEMALE
thomasine	FEMALE
thresa	FEMALE
thu	FEMALE
thurman	MALE
thuy	FEMALE
tia	FEMALE
tiana	FEMALE
tianna	FEMALE
tiara	FEMALE
tierra	FEMALE
tiesha	FEMALE
tiffani	FEMALE
tiffanie	FEMALE
tiffany	FEMALE
tiffiny	FEMALE
tillie	FEMALE
tim	MALE
timmy	MALE
timothy	MALE
tina	FEMALE
tiny	FEMALE
tisha	FEMALE
titus	MALE
tobias	MALE
toby	MALE
tod	MALE
todd	MALE
tom	MALE
tomas	MALE
tomasa	FEMALE
tomeka	FEMALE
tomika	FEMALE
tommie	FEMALE
tommie	MALE
tommy	MALE
tomoko	FEMALE
tonda	FEMALE
toney	MALE
toni	FEMALE
tonia	FEMALE
tonie	FEMALE
tonja	FEMALE
tony	MALE
tori	FEMALE
tory	MALE
tosha	FEMALE
towanda	FEMALE
toya	FEMALE
tracee	FEMALE
tracey	FEMALE
tracey	MALE
traci	FEMALE
tracie	FEMALE
tracy	FEMALE
trang	FEMALE
travis	MALE
trena	FEMALE
trent	MALE
trenton	MALE
tresa	FEMALE
tressa	FEMALE
tressie	FEMALE
treva	FEMALE
trevor	MALE
trey	MALE
tricia	FEMALE
trina	FEMALE
trinidad	FEMALE
trinidad	MALE
trinity	FEMALE
trish	FEMALE
trisha	FEMALE
trista	FEMALE
tristan	FEMALE
tristan	MALE
troy	MALE
trudi	FEMALE
trudie	FEMALE
trudy	FEMALE
trula	FEMALE
truman	MALE
tuan	MALE
tuyet	FEMALE
twana	FEMALE
twila	FEMALE
twyla	FEMALE
ty	MALE
tyesha	FEMALE
tyler	MALE
tyra	FEMALE
tyree	MALE
tyrell	MALE
tyron	MALE
tyrone	MALE
tyson	MALE
ulysses	MALE
una	FEMALE
ursula	FEMALE
vada	FEMALE
val	FEMALE
val	MALE
valarie	FEMALE
valda	FEMALE
valencia	FEMALE
valentin	MALE
valentina	FEMALE
valentine	MALE
valeria	FEMALE
valerie	FEMALE
valery	FEMALE
vallie	FEMALE
valorie	FEMALE
van	FEMALE
van	MALE
vance	MALE
vanda	FEMALE
vanesa	FEMALE
vanessa	FEMALE
vanita	FEMALE
vannessa	FEMALE
vaughn	MALE
veda	FEMALE
velda	FEMALE
velia	FEMALE
vella	FEMALE
velma	FEMALE
velva	FEMALE
velvet	FEMALE
vena	FEMALE
venessa	FEMALE
venice	FEMALE
venita	FEMALE
venus	FEMALE
vera	FEMALE
verda	FEMALE
verdell	FEMALE
verdie	FEMALE
verena	FEMALE
vergie	FEMALE
verla	FEMALE
verlene	FEMALE
verlie	FEMALE
vern	MALE
verna	FEMALE
vernell	FEMALE
vernetta	FEMALE
vernice	FEMALE
vernie	FEMALE
vernita	FEMALE
vernon	MALE
verona	FEMALE
veronica	FEMALE
versie	FEMALE
vesta	FEMALE
veta	FEMALE
vicenta	FEMALE
vicente	MALE
vickey	FEMALE
vicki	FEMALE
vickie	FEMALE
vicky	FEMALE
victor	MALE
victoria	FEMALE
vida	FEMALE
vikki	FEMALE
vilma	FEMALE
vina	FEMALE
vince	MALE
vincent	MALE
vincenza	FEMALE
vincenzo	MALE
vinnie	FEMALE
viola	FEMALE
violet	FEMALE
violeta	FEMALE
violette	FEMALE
virgie	FEMALE
virgil	MALE
virgilio	MALE
virgina	FEMALE
virginia	FEMALE
vita	FEMALE
vito	MALE
viva	FEMALE
vivan	FEMALE
vivian	FEMALE
viviana	FEMALE
vivien	FEMALE
vivienne	FEMALE
von	MALE
vonda	FEMALE
vonnie	FEMALE
wade	MALE
wai	FEMALE
waldo	MALE
walker	MALE
wallace	MALE
wally	MALE
walter	MALE
walton	MALE
waltraud	FEMALE
wanda	FEMALE
wanita	FEMALE
ward	MALE
warner	MALE
warren	MALE
waylon	MALE
wayne	MALE
wei	FEMALE
weldon	MALE
wendell	MALE
wendi	FEMALE
wendy	FEMALE
werner	MALE
wes	MALE
wesley	MALE
weston	MALE
whitney	FEMALE
wilber	MALE
wilbert	MALE
wilbur	MALE
wilburn	MALE
wilda	FEMALE
wiley	MALE
wilford	MALE
wilfred	MALE
wilfredo	MALE
wilhelmina	FEMALE
will	MALE
willa	FEMALE
willard	MALE
willene	FEMALE
willette	FEMALE
willia	FEMALE
william	MALE
williams	MALE
willian	MALE
willie	MALE
willis	MALE
willy	MALE
wilma	FEMALE
wilmer	MALE
wilson	MALE
wilton	MALE
windy	FEMALE
winford	MALE
winfred	MALE
winifred	FEMALE
winnie	FEMALE
winnifred	FEMALE
winona	FEMALE
winston	MALE
wm	MALE
wonda	FEMALE
woodrow	MALE
wyatt	MALE
wynona	FEMALE
xavier	MALE
xiomara	FEMALE
yadira	FEMALE
yan	FEMALE
yang	FEMALE
yanira	FEMALE
yasmin	FEMALE
yee	FEMALE
yen	FEMALE
yesenia	FEMALE
yetta	FEMALE
yi	FEMALE
ying	FEMALE
yoko	FEMALE
yolanda	FEMALE
yolande	FEMALE
yolando	FEMALE
yolonda	FEMALE
yong	FEMALE
yong	MALE
yoshiko	FEMALE
young	FEMALE
young	MALE
yu	FEMALE
yukiko	FEMALE
yuko	FEMALE
yun	FEMALE
yvette	FEMALE
yvonne	FEMALE
zachariah	MALE
zachary	MALE
zachery	MALE
zack	MALE
zackary	MALE
zaida	FEMALE
zandra	FEMALE
zane	MALE
zelda	FEMALE
zella	FEMALE
zelma	FEMALE
zena	FEMALE
zenaida	FEMALE
zenobia	FEMALE
zina	FEMALE
zita	FEMALE
zoe	FEMALE
zofia	FEMALE
zoila	FEMALE
zola	FEMALE
zona	FEMALE
zora	FEMALE
zoraida	FEMALE
zula	FEMALE
zulema	FEMALE
zulma	FEMALE
aaarti	FEMALE
aabha	MALE
aabharan	MALE
aabheer	MALE
aabher	MALE
aadab	FEMALE
aadarsh	MALE
aadarshini	FEMALE
aadesh	MALE
aadhira	MALE
aadhishankar	MALE
aadhunik	MALE
aadi	MALE
aadil	MALE
aadinath	MALE
aadita	FEMALE
aaditey	MALE
aaditya	MALE
aafreen	FEMALE
aafreen	MALE
aagney	MALE
aahana	FEMALE
aahlaad	MALE
aahlaadith	MALE
aahna	FEMALE
aahwaanith	MALE
aakaanksha	FEMALE
aakaar	MALE
aakanksh	MALE
aakar	MALE
aakarsh	MALE
aakash	MALE
aakesh	MALE
aakriti	FEMALE
aalam	MALE
aalap	MALE
aalia	FEMALE
aalok	MALE
aamaal	FEMALE
aamani	FEMALE
aamir	MALE
aamod	MALE
aanandita	FEMALE
aanchal	FEMALE
aandaleeb	MALE
aaratrika	FEMALE
aarav	MALE
aarif	MALE
aarnav	MALE
aarne	MALE
aarno	MALE
aarpit	MALE
aarti	FEMALE
aarunya	FEMALE
aarush	MALE
aarushi	FEMALE
aaryan	MALE
aarzoo	FEMALE
aashank	MALE
aashi	FEMALE
aashirya	FEMALE
aashish	MALE
aashiyana	FEMALE
aashna	FEMALE
aashni	FEMALE
aashritha	FEMALE
aashvi	FEMALE
aasim	MALE
aasit	MALE
aasmaa	FEMALE
aastha	FEMALE
aathmika	FEMALE
aatish	MALE
aatmaja	FEMALE
aayan	MALE
aayushi	FEMALE
abaan	MALE
abani	FEMALE
abbas	MALE
abdel kader	MALE
abdel-rahim	MALE
abdelaziz	MALE
abdelhadi	MALE
abdelmajid	MALE
abdessamad	MALE
abdul-azeez	MALE
abdul-baari	MALE
abdul-ghafoor	MALE
abdul-haafiz	MALE
abdul-hameed	MALE
abdul-haseeb	MALE
abdul-jabaar	MALE
abdul-jaleel	MALE
abdul-khaaliq	MALE
abdul-qaadir	MALE
abdul-qahaar	MALE
abdul-qudoos	MALE
abdul-raheem	MALE
abdul-raouf	MALE
abdul-rasheed	MALE
abdul-razaaq	MALE
abdul-salaam	MALE
abdul-waahid	MALE
abdul-wadood	MALE
abdulaziz	MALE
abdullah	MALE
abdulmohsen	MALE
abdulrahman	MALE
abdusalam	MALE
abed	MALE
abedin	MALE
abeer	FEMALE
abezag	MALE
abha	FEMALE
abhay	MALE
abhaya	FEMALE
abhayananda	MALE
abhayaprada	MALE
abheek	MALE
abhibhava	MALE
abhichandra	MALE
abhidi	MALE
abhihita	MALE
abhijat	MALE
abhijay	MALE
abhijaya	MALE
abhijit	MALE
abhijvala	MALE
abhilash	MALE
abhilasha	FEMALE
abhimand	MALE
abhimani	MALE
abhimanyu	MALE
abhimanyusuta	MALE
abhimoda	MALE
abhinabhas	MALE
abhinanda	MALE
abhinandan	MALE
abhinandana	MALE
abhinatha	MALE
abhinav	MALE
abhinava	MALE
abhinay	MALE
abhineet	MALE
abhipsa	FEMALE
abhiraj	MALE
abhirup	MALE
abhisha	MALE
abhishek	MALE
abhisoka	MALE
abhisumat	MALE
abhisyanta	MALE
abhitha	FEMALE
abhivira	MALE
abhra	MALE
abhrakasin	MALE
abhyagni	MALE
abhyudaya	MALE
abhyudita	MALE
abimanyu	MALE
abirami	FEMALE
abishek	MALE
abjayoni	MALE
abjit	MALE
ablaa	FEMALE
aboil	FEMALE
aboli	FEMALE
abra	MALE
abrar	MALE
abu	MALE
abul	MALE
acaryatanaya	MALE
acchutan	MALE
achal	MALE
achala	FEMALE
achalapati	MALE
achalendra	MALE
achalesvara	MALE
achanda	MALE
acharya	MALE
acharyanandana	MALE
acharyasuta	MALE
achim	MALE
achindra	MALE
achintya	MALE
achla	FEMALE
achyut	MALE
achyuta	MALE
achyutaraya	MALE
adalarasu	MALE
adarsh	FEMALE
adarsh	MALE
adeel	MALE
adeela	FEMALE
adesh	MALE
adham	MALE
adhik	MALE
adhikara	MALE
adhipa	MALE
adhira	FEMALE
adhiraj	MALE
adhita	MALE
adikavi	MALE
adil	MALE
adinath	MALE
adishree	FEMALE
adit	MALE
aditeya	MALE
adithya	MALE
aditi	FEMALE
aditya	MALE
adityanandana	MALE
adityavardhana	MALE
adiya	FEMALE
adnan	MALE
adnane	MALE
adri?	MALE
adria?de	MALE
adrian	MALE
adrika	FEMALE
adripathi	MALE
advaita	MALE
advaith	MALE
advay	MALE
adwait	MALE
adwaita	MALE
adwaith	MALE
adway	MALE
adwita	FEMALE
adwiteya	FEMALE
adwitiya	FEMALE
aesha	FEMALE
afaf	FEMALE
afeef	MALE
afra	FEMALE
afraa	FEMALE
afrah	FEMALE
afreen	FEMALE
afsaneh	FEMALE
aftab	MALE
afzal	MALE
agamya	FEMALE
agasthya	MALE
agasti	MALE
aggeliki	FEMALE
agha	MALE
aghanashini	FEMALE
agharna	MALE
aghat	MALE
agnello	MALE
agneya	MALE
agnieszka	FEMALE
agnikumara	MALE
agniprava	MALE
agrata	FEMALE
agrim	MALE
agrima	FEMALE
agrima	MALE
agriya	MALE
agust?n	MALE
agusti	MALE
ahalya	FEMALE
ahanti	FEMALE
ahd	FEMALE
ahilya	FEMALE
ahir	MALE
ahladita	FEMALE
ahlam	FEMALE
ahmad	MALE
ahmet	MALE
ahren	MALE
ahrmshulla	FEMALE
ahsan	MALE
aicha	FEMALE
aida	FEMALE
aidan	MALE
aijaz	MALE
aika	FEMALE
aiko	FEMALE
aiman	MALE
aimi	FEMALE
aimiah	FEMALE
aina	FEMALE
ainesh	MALE
aingeru	MALE
airi	FEMALE
aisha	FEMALE
aishani	FEMALE
aishwarya	FEMALE
aitao	MALE
aitor	MALE
aitziber	FEMALE
ajala	FEMALE
ajamil	MALE
ajanta	FEMALE
ajastha	FEMALE
ajatashatru	MALE
ajay	MALE
ajeet	MALE
ajendra	MALE
ajia	FEMALE
ajinkya	MALE
ajit	MALE
ajita	FEMALE
ajitabh	MALE
ajitesh	MALE
ajmal	MALE
ajoy	MALE
akahito	MALE
akakpo	MALE
akalmash	MALE
akand	MALE
akane	FEMALE
akanksha	FEMALE
akansh	MALE
akash	MALE
akbar	MALE
akemi	FEMALE
akeno	MALE
akhil	MALE
akhila	FEMALE
akhilesh	MALE
akhyath	MALE
aki	FEMALE
aki	MALE
akifumi	MALE
akihiko	MALE
akihiro	MALE
akihisa	MALE
akihito	MALE
akikazu	MALE
akiko	FEMALE
akilesh	MALE
akina	FEMALE
akinari	MALE
akinori	MALE
akio	MALE
akira	MALE
akitoshi	MALE
akmal	MALE
akram	MALE
akrash	MALE
akriti	FEMALE
akroor	MALE
akshad	MALE
akshadha	FEMALE
akshainie	FEMALE
akshaj	MALE
akshan	MALE
akshar	MALE
akshara	FEMALE
akshat	MALE
akshata	FEMALE
akshath	MALE
akshay	MALE
akshaya	FEMALE
akshi	FEMALE
akshit	MALE
akshita	FEMALE
akshun	MALE
akul	MALE
akuro	FEMALE
akuti	FEMALE
al	MALE
alaa	MALE
alabhya	FEMALE
alagan	MALE
alagarasu	MALE
alain	MALE
alaine-pierre	MALE
alak	FEMALE
alaka	FEMALE
alaknanda	FEMALE
alaksha	FEMALE
alam	MALE
alamgir	MALE
alankrita	FEMALE
alastair	MALE
alazae	MALE
albena	FEMALE
aleem	MALE
alejandro	MALE
alekhya	FEMALE
aleksandar	MALE
aleksander	MALE
aleksandr	MALE
alessandra	FEMALE
alessandro	MALE
alessio	MALE
aletrice	FEMALE
alevtina	FEMALE
alex	MALE
alexandr	MALE
alexandre	MALE
alexandru	MALE
alexei	MALE
alexey	MALE
alexiei	MALE
alfons	MALE
alhad	MALE
ali	MALE
alia	FEMALE
alif	MALE
alisha	FEMALE
alistair	MALE
aljoscha	MALE
alka	FEMALE
almas	FEMALE
alois	MALE
alok	MALE
aloke	MALE
aloki	FEMALE
alon	MALE
alona	FEMALE
alopa	FEMALE
alpa	FEMALE
alpana	FEMALE
alpesh	MALE
alpita	FEMALE
altaf	MALE
amaanath	MALE
amaanya	FEMALE
amal	MALE
amala	FEMALE
amalendu	MALE
amalesh	MALE
aman	MALE
amane	MALE
amani	FEMALE
amar	MALE
amarante	FEMALE
amardeep	MALE
amartya	MALE
amaterasu	FEMALE
amatullah	FEMALE
amaury	MALE
amaya	FEMALE
amba	FEMALE
ambar	MALE
ambarish	MALE
ambika	FEMALE
ambu	FEMALE
ambuda	FEMALE
ambuj	MALE
ambuja	FEMALE
amedeo	MALE
ameen	MALE
ameena	FEMALE
ameer	MALE
ameera	FEMALE
amelie	FEMALE
ameya	MALE
ami	FEMALE
amichai	MALE
amihood	MALE
amil	MALE
amin	MALE
amine	MALE
amir	MALE
amish	MALE
amisha	FEMALE
amishi	FEMALE
amit	MALE
amita	FEMALE
amitabh	MALE
amitava	MALE
amitbikram	MALE
amitesh	MALE
amithi	FEMALE
amitiyoti	MALE
amitjyoti	FEMALE
amitrasudan	MALE
amittai	MALE
amiya	FEMALE
amiya	MALE
amjad	MALE
amla	FEMALE
amlan	MALE
amlankusum	MALE
ammar	MALE
ammu	FEMALE
amnon	MALE
amod	MALE
amoda	FEMALE
amodini	FEMALE
amogh	MALE
amoha	MALE
amol	MALE
amolik	MALE
amolika	FEMALE
amr	MALE
amrapali	FEMALE
amresh	MALE
amrish	MALE
amrit	MALE
amrita	FEMALE
amritambu	FEMALE
amritkala	FEMALE
amrusha	FEMALE
amruta	FEMALE
amshu	MALE
amshul	MALE
amshula	FEMALE
amuk	MALE
amul	MALE
amulya	FEMALE
amulya	MALE
amvi	FEMALE
amy	FEMALE
ana	FEMALE
ana-maria	FEMALE
anaan	FEMALE
anabela	FEMALE
anadi	MALE
anagha	FEMALE
anahata	FEMALE
anahita	FEMALE
anaiya	FEMALE
anal	MALE
anala	FEMALE
analilia	FEMALE
anam	FEMALE
anamika	FEMALE
anamitra	FEMALE
anamitra	MALE
anand	MALE
anandamayi	FEMALE
anandani	FEMALE
anandi	FEMALE
anandini	FEMALE
anandita	FEMALE
ananga	MALE
ananlada	FEMALE
ananmaya	MALE
anant	MALE
ananth	MALE
ananthakrishnan	MALE
ananti	FEMALE
anantika	FEMALE
anantram	MALE
ananya	FEMALE
anarghya	FEMALE
anarghya	MALE
anas	MALE
anasooya	FEMALE
anastasios	MALE
anasua	FEMALE
anasuya	FEMALE
anathakrishnan	MALE
anavi	FEMALE
anbar	FEMALE
anbarasu	MALE
anbu	MALE
anbuchelvan	MALE
anbumadi	MALE
anbuselvan	MALE
anca	FEMALE
anchal	FEMALE
anchita	FEMALE
anda	FEMALE
andee	FEMALE
anders	MALE
andi	MALE
andr&#233	MALE
andr?	MALE
andr?s	MALE
andras	MALE
andre	MALE
andrei	MALE
andrej	MALE
andrey	MALE
andreyeva	FEMALE
andriela	FEMALE
andrius	MALE
andriy	MALE
anees	MALE
aneesa	FEMALE
anek	MALE
aneko	FEMALE
aneri	FEMALE
anesh	MALE
angad	MALE
angada	MALE
angaj	MALE
angamuthu	MALE
angana	FEMALE
angarika	FEMALE
angel	MALE
angelia	FEMALE
angelien	FEMALE
angha	FEMALE
angleen	FEMALE
angoori	FEMALE
angus	MALE
ani	FEMALE
anika	FEMALE
anikait	MALE
anil	MALE
anima	FEMALE
animesh	MALE
animish	MALE
anindita	FEMALE
anirban	MALE
anirudh	MALE
anirudhha	MALE
anirvan	MALE
anirvinya	MALE
anisa	MALE
anish	MALE
anisha	FEMALE
anissa	FEMALE
anita	FEMALE
aniteja	MALE
anja	FEMALE
anjali	FEMALE
anjana	FEMALE
anjani	MALE
anjas	MALE
anjasa	MALE
anjika	FEMALE
anjini	FEMALE
anjor	MALE
anju	FEMALE
anjum	MALE
anjuman	MALE
anjushree	FEMALE
anjushri	FEMALE
ankal	FEMALE
anke	FEMALE
ankit	MALE
ankita	FEMALE
ankur	MALE
ankush	MALE
anlei	MALE
anmol	FEMALE
anmol	MALE
anna	FEMALE
annacellie	FEMALE
annada	FEMALE
annalu	FEMALE
annapoorna	FEMALE
annapurna	FEMALE
annarosa	FEMALE
anne-marie	FEMALE
annelies	FEMALE
annelise	FEMALE
anni	FEMALE
annibale	MALE
annika	FEMALE
annjaya	FEMALE
annuabhuj	MALE
anokhi	FEMALE
anoop	MALE
anosh	MALE
anouka	FEMALE
anoushka	FEMALE
anram	MALE
ansar	MALE
anselmo	MALE
ansh	MALE
ansha	FEMALE
anshika	FEMALE
anshita	FEMALE
anshu	FEMALE
anshu	MALE
anshul	MALE
anshula	FEMALE
anshumali	FEMALE
anshuman	MALE
anshumat	MALE
ansuya	FEMALE
ant?nio	MALE
antal	MALE
antara	FEMALE
antariksha	FEMALE
antje	FEMALE
antonella	FEMALE
antonin	MALE
antrix	MALE
antti	MALE
antti-veikko	MALE
antton	MALE
anu	FEMALE
anubha	FEMALE
anubhav	MALE
anubhuti	FEMALE
anugraha	FEMALE
anugya	MALE
anuha	MALE
anuhya	FEMALE
anuj	MALE
anuja	FEMALE
anukeertana	FEMALE
anula	FEMALE
anumati	FEMALE
anumita	FEMALE
anunay	MALE
anup	MALE
anupa	FEMALE
anupam	MALE
anupama	FEMALE
anuprabha	FEMALE
anupriya	FEMALE
anuraag	MALE
anuradha	FEMALE
anurag	MALE
anuragini	FEMALE
anurati	FEMALE
anush	MALE
anusha	FEMALE
anushka	FEMALE
anushree	FEMALE
anushri	FEMALE
anuttam	MALE
anuva	FEMALE
anvesh	MALE
anvi	FEMALE
anwaar	FEMALE
anwar	MALE
anwesha	FEMALE
anya	FEMALE
anzai	MALE
aoife	FEMALE
apala	FEMALE
aparajita	FEMALE
aparijita	FEMALE
aparna	FEMALE
apekshaa	FEMALE
apoorv	MALE
apoorva	MALE
appaji	MALE
apparajito	MALE
apsara	FEMALE
apurba	FEMALE
apurva	FEMALE
apurva	MALE
apurva;	FEMALE
aqilah	FEMALE
aquil	MALE
ara	FEMALE
aradhana	FEMALE
arantxa	FEMALE
arantza	FEMALE
arash	MALE
arata	MALE
arati	FEMALE
arav	MALE
aravali	MALE
aravind	MALE
arcady	MALE
archa	FEMALE
archan	FEMALE
archan	MALE
archana	FEMALE
archibald	MALE
archisha	FEMALE
archit	MALE
archita	FEMALE
arda	MALE
ardhendu	MALE
areebah	FEMALE
areej	FEMALE
arghya	MALE
arha	MALE
arhan	MALE
ari	MALE
aria	MALE
ariadna	FEMALE
ariane	FEMALE
ariani	FEMALE
ariel	MALE
ariez	MALE
arihant	MALE
arijit	MALE
arina	FEMALE
arindam	MALE
arinjay	MALE
arinori	MALE
aris	MALE
arisa	FEMALE
arisu	FEMALE
aritomo	MALE
aritra	MALE
arivalagan	MALE
arivali	MALE
arivarasu	MALE
arivoli	MALE
arivuchelvan	MALE
arivumadhi	MALE
arivunambi	MALE
arja	FEMALE
arja	MALE
arjan	MALE
arjav	MALE
arjen	MALE
arjit	MALE
arjun	MALE
arka	MALE
arkaan	MALE
arkady	MALE
arkaitz	MALE
arkita	FEMALE
armin	MALE
arnab	MALE
arnaldo	MALE
arnaud	MALE
arnav	MALE
arndt	MALE
arne	MALE
arnesh	MALE
arnima	FEMALE
arno	MALE
arokya	MALE
aroma	FEMALE
aron	MALE
aroob	FEMALE
aroon	MALE
arpan	MALE
arpana	FEMALE
arpita	FEMALE
arrush	MALE
arsalan	MALE
arsh	MALE
arshad	MALE
arshia	FEMALE
arti	FEMALE
arul	MALE
arulchelvan	MALE
arulselvan	MALE
arumugan	MALE
arun	MALE
aruna	FEMALE
arundhati	FEMALE
aruni	FEMALE
aruni	MALE
arunima	FEMALE
arup	MALE
arvi	MALE
arvind	MALE
arvinda	MALE
arwa	FEMALE
arya	MALE
aryahi	FEMALE
aryaman	MALE
aryan	MALE
aryana	FEMALE
aryavan	MALE
arzucan	FEMALE
asad	MALE
asaf	MALE
asah	FEMALE
asako	FEMALE
asalah	FEMALE
asami	FEMALE
asao	MALE
asarat	FEMALE
asavari	FEMALE
asawari	FEMALE
ascander	MALE
ascension	FEMALE
ascharya	FEMALE
aseelah	FEMALE
aseem	MALE
aseema	FEMALE
asgar	MALE
asgari	FEMALE
asha	FEMALE
ashakiran	FEMALE
ashalata	FEMALE
ashank	MALE
ashara	FEMALE
ashavari	FEMALE
asheem	MALE
asher	MALE
ashfaq	MALE
ashi	FEMALE
ashihei	MALE
ashima	FEMALE
ashis	FEMALE
ashis	MALE
ashish	MALE
ashit	MALE
ashita	FEMALE
ashka	FEMALE
ashlesha	FEMALE
ashley	MALE
ashlynn	FEMALE
ashmi	FEMALE
ashmita	FEMALE
ashna	FEMALE
ashneel	MALE
ashok	MALE
ashraf	MALE
ashritha	FEMALE
ashu	MALE
ashutosh	MALE
ashvin	MALE
ashwath	MALE
ashwatthama	MALE
ashwin	MALE
ashwina	FEMALE
ashwini	FEMALE
asif	MALE
asija	MALE
asim	MALE
asit	MALE
asita	FEMALE
asiya	FEMALE
asjid	MALE
aslam	MALE
aslesh	MALE
aslesha	FEMALE
asli	FEMALE
asma	FEMALE
asmita	FEMALE
asuka	FEMALE
asunci	FEMALE
asunci?n	FEMALE
aswal	MALE
aswathi	FEMALE
ataa	MALE
atal	MALE
atambhu	MALE
atanas	MALE
atanu	MALE
atasi	FEMALE
atasuke	MALE
atefeh	FEMALE
atelach	FEMALE
athanasios	MALE
athanassia	FEMALE
atharva	MALE
atharvan	MALE
athina	FEMALE
athiya	MALE
athrv	MALE
atif	FEMALE
atif	MALE
atimanav	MALE
atinder	MALE
atit	MALE
atiya	FEMALE
atma	MALE
atmaja	FEMALE
atmaja	MALE
atmajyoti	MALE
atmanand	MALE
atmananda	MALE
atmikha	FEMALE
atraiu	MALE
atralarasu	MALE
atre	MALE
atreyi	FEMALE
atshushi	MALE
atsue	FEMALE
atsuko	FEMALE
atsumichi	MALE
atsumori	MALE
atsuo	MALE
atsushi	MALE
atsutane	MALE
attila	MALE
attiya	FEMALE
atul	MALE
atula	FEMALE
aurel	FEMALE
aurelie	FEMALE
ausija	MALE
avadhesh	MALE
avani	FEMALE
avanindra	MALE
avanish	MALE
avanti	FEMALE
avanti(ancient	FEMALE
avantika	FEMALE
avaron	FEMALE
avasyu	MALE
avatar	MALE
avi	MALE
avijit	MALE
avikam	MALE
avikshit	MALE
avilash	MALE
avin	MALE
avinash	MALE
avinashi	FEMALE
avipsa	FEMALE
aviral	MALE
avirat	MALE
avish	MALE
avishek	MALE
avkash	MALE
avneet	FEMALE
avni	FEMALE
avnita	FEMALE
avtar	MALE
awad	MALE
aws	MALE
axel	MALE
aya	FEMALE
ayaan	MALE
ayaaz	MALE
ayaka	FEMALE
ayako	FEMALE
ayame	FEMALE
ayan	MALE
ayane	FEMALE
ayanna	FEMALE
ayano	FEMALE
ayati	FEMALE
ayavanth	MALE
ayeesha	FEMALE
ayeh	FEMALE
ayesha	FEMALE
ayman	MALE
ayog	MALE
ayona	FEMALE
ayoob	MALE
ayumi	FEMALE
ayumu	MALE
ayush	MALE
ayushi	FEMALE
ayushmati	FEMALE
ayyappa	MALE
azalea	FEMALE
azeez	MALE
azeeza	FEMALE
azhaar	FEMALE
azhar	MALE
aziza	FEMALE
azumamaro	MALE
azumi	FEMALE
azza	FEMALE
azzaam	MALE
azzah	FEMALE
azzam	MALE
b?atrice	FEMALE
baahir	MALE
baasim	MALE
baasima	FEMALE
badal	MALE
baden	MALE
badr	MALE
badri	MALE
badrinath	MALE
badriprasad	MALE
badriya	FEMALE
bageshri	FEMALE
baha	MALE
baheera	FEMALE
bahiy	MALE
bahiyaa	FEMALE
bahubali	MALE
bahula	FEMALE
bahuleya	MALE
bahuliya	MALE
baidehi	FEMALE
baijayanthi	FEMALE
baiko	MALE
bairavi	FEMALE
bairei	MALE
baisakhi	FEMALE
baishali	FEMALE
bajrang	MALE
bakin	MALE
bakool	MALE
bakul	FEMALE
bakula	FEMALE
bala	FEMALE
balaaditya	MALE
balachandar	MALE
balachandra	MALE
balagopal	MALE
balagovind	MALE
balaji	MALE
balakrishna	MALE
balakrishnan	MALE
balamani	MALE
balamohan	MALE
balamohan(one	MALE
balaram	MALE
balaraman	MALE
balazs	MALE
balbir	MALE
baldev	MALE
balgopal	MALE
balgovind	MALE
bali	MALE
ballari	FEMALE
balqis	FEMALE
balram	MALE
balvindra	MALE
balwant	MALE
banaj	MALE
banamala	FEMALE
banan	FEMALE
banani	FEMALE
banbihari	MALE
bandana	FEMALE
bandhu	MALE
bandhul	MALE
bandhula	FEMALE
bandhura	FEMALE
bandish	MALE
banhi	FEMALE
banhishikha	FEMALE
banita	FEMALE
banke	MALE
bankebihari	MALE
bankim	MALE
bankimchandra	MALE
banni	FEMALE
bansari	FEMALE
bansi	MALE
bansilal	MALE
banwari	MALE
baobao	MALE
baoshi	MALE
baraa'a	FEMALE
baran	MALE
barbora	FEMALE
barid	MALE
baridbaran	MALE
barindra	MALE
barisha	FEMALE
barkha	FEMALE
barnali	FEMALE
barsaat	MALE
barsha	FEMALE
bartosz	MALE
barun	MALE
baruna	FEMALE
baruni	FEMALE
basaam	MALE
basabi	FEMALE
basant	MALE
basanta	MALE
basanti	FEMALE
baseema	FEMALE
basel	MALE
bashaar	MALE
basheera	FEMALE
bashir	MALE
basho	MALE
basia	FEMALE
basilio	MALE
basilis	MALE
basistha	MALE
basma	FEMALE
bassam	MALE
basudha	MALE
batool	FEMALE
batuk	MALE
bayan	FEMALE
be?ta	FEMALE
beat	FEMALE
beata	FEMALE
beate	FEMALE
beena	FEMALE
bela	FEMALE
beli	FEMALE
belli	FEMALE
benazir	FEMALE
benfeng	MALE
bengt	MALE
benjiro	MALE
benkei	MALE
bennifer	FEMALE
beno&#238	MALE
beno?t	MALE
benoit	MALE
benten	FEMALE
berenike	FEMALE
berfin	FEMALE
berlin	MALE
bernardino	MALE
bernat	MALE
bernd	MALE
bernhard	MALE
berthold	MALE
bertil	MALE
bertjan	MALE
bertol	MALE
bertrand	MALE
bertus	MALE
betsy	FEMALE
beum-seuk	MALE
bhadra	FEMALE
bhadrak	MALE
bhadraksh	MALE
bhagirath	MALE
bhagirathi	FEMALE
bhagwant	MALE
bhagwanti	FEMALE
bhagwati	FEMALE
bhagya	FEMALE
bhagyalakshmi	FEMALE
bhagyaraj	MALE
bhagyashree	FEMALE
bhagyashri	FEMALE
bhagyawati	FEMALE
bhairav	MALE
bhairavi	FEMALE
bhajan	MALE
bhakti	FEMALE
bhamini	FEMALE
bhanu	FEMALE
bhanu	MALE
bhanudas	MALE
bhanuja	FEMALE
bhanumati	FEMALE
bhanuni	FEMALE
bhanuprasad	MALE
bhanupriya	FEMALE
bharadwaj	MALE
bharani	FEMALE
bharat	MALE
bharati	FEMALE
bharddwaj	MALE
bhargav	MALE
bhargava	MALE
bhargavan	MALE
bhargavi	FEMALE
bhargavi	MALE
bhaskar	MALE
bhaumi	FEMALE
bhaumik	MALE
bhav	MALE
bhavana	FEMALE
bhavani	FEMALE
bhavesh	MALE
bhavi	FEMALE
bhavik	MALE
bhavika	FEMALE
bhavin	MALE
bhavini	FEMALE
bhavna	FEMALE
bhavya	MALE
bhawna	FEMALE
bheru	MALE
bhiksha	MALE
bhilangana	FEMALE
bhim	MALE
bhini	FEMALE
bhishma	MALE
bhoomi	FEMALE
bhoomika	FEMALE
bhooshan	MALE
bhooshit	MALE
bhrij	MALE
bhrithi	FEMALE
bhudev	MALE
bhudhav	MALE
bhuman	MALE
bhumi	MALE
bhumika	FEMALE
bhupad	MALE
bhupal	MALE
bhupati	MALE
bhupen	MALE
bhupendra	MALE
bhushan	MALE
bhuvan	MALE
bhuvana	FEMALE
bhuvanesh	MALE
bhuvi	FEMALE
bianca	FEMALE
bianka	FEMALE
bibek	MALE
bibhas	MALE
bibhavasu	MALE
biboswan	MALE
bigul	MALE
bijal	FEMALE
bijli	FEMALE
bikram	MALE
bilal	MALE
bilva	MALE
bimal	MALE
bimala	FEMALE
bimb	MALE
bimbi	FEMALE
bina	FEMALE
binaisha	FEMALE
binata	FEMALE
bindiya	FEMALE
bindu	FEMALE
bindusar	MALE
binita	FEMALE
binodini	FEMALE
bipasha	FEMALE
bipin	MALE
bir	MALE
biraj	MALE
birbal	MALE
biren	MALE
birendra	MALE
birinder	MALE
birte	FEMALE
bishakha	FEMALE
bishr	MALE
bisujaksha	MALE
bitasok	MALE
bj&#246	MALE
bjarne	MALE
bjoern	MALE
bjorn	MALE
bjornar	MALE
blaise	MALE
blandine	FEMALE
blessy	FEMALE
bo-june (paul)	MALE
bo-yeong	FEMALE
bodhan	MALE
bogdan	MALE
bojan	MALE
bojana	FEMALE
bokkai	MALE
bor-shen	MALE
borislav	MALE
botan	MALE
boudhayan	MALE
bowden	MALE
bowen	MALE
boxing	MALE
boyan	MALE
bozena	FEMALE
bozo	MALE
brahmabrata	MALE
brahmadutt	MALE
branimir	MALE
bratati	FEMALE
bratindra	MALE
breck	MALE
breonna	FEMALE
bretonnel	MALE
brij	MALE
brijesh	MALE
brijmohan	MALE
brinda	FEMALE
briony	FEMALE
britta	FEMALE
bryan	MALE
bubby	FEMALE
buddhadev	MALE
buddhadeva	MALE
budhil	MALE
bulbul	FEMALE
bulbuli	FEMALE
buncho	MALE
bunjiro	MALE
bunko	FEMALE
bunny	FEMALE
bunny	MALE
bunrakuken	MALE
bunzo	MALE
burcu	FEMALE
burghard	MALE
burhaan	MALE
bushra	FEMALE
bussho	MALE
buthayna	FEMALE
byeong man	MALE
byeong-kwu	MALE
byeongchang	MALE
byoung-kee	MALE
byung-kwan	MALE
c	>	MALE
c&#233	FEMALE
c??cile	FEMALE
c?cero	MALE
c?dric	MALE
caesar	MALE
camerina	FEMALE
cammy	FEMALE
carel	MALE
carina	FEMALE
carolin	FEMALE
caroline	FEMALE
carsten	MALE
casey	MALE
casimir	MALE
cassandre	FEMALE
cassiana	FEMALE
catherine	FEMALE
cathy	FEMALE
catia	FEMALE
cauvery	FEMALE
ceeven	MALE
cem	MALE
chaaya	FEMALE
chadna	FEMALE
chahel	MALE
chahna	FEMALE
chain	MALE
chaitali	FEMALE
chaitaly	FEMALE
chaitan	FEMALE
chaitanya	MALE
chaitra	FEMALE
chakor	MALE
chakori	FEMALE
chakradev	MALE
chakradhar	MALE
chakrapani	MALE
chakravarthi	MALE
chakrika	FEMALE
chakshu	MALE
chalama	FEMALE
chaman	FEMALE
chaman	MALE
chamanlal	MALE
chameli	FEMALE
champa	FEMALE
champabati	FEMALE
champak	MALE
champakali	FEMALE
chanakya	MALE
chanchal	FEMALE
chanchal	MALE
chanchala	FEMALE
chandak	MALE
chandan	FEMALE
chandan	MALE
chandana	FEMALE
chandani	FEMALE
chandanika	FEMALE
chandi	FEMALE
chandika	FEMALE
chandni	FEMALE
chandra	FEMALE
chandra	MALE
chandrabali	FEMALE
chandrabhaga	FEMALE
chandrachur	MALE
chandrahas	MALE
chandrak	MALE
chandrakala	FEMALE
chandrakanta	MALE
chandraki	FEMALE
chandrakin	FEMALE
chandrakishore	MALE
chandrakumar	MALE
chandraleksha	FEMALE
chandramohan	MALE
chandran	MALE
chandranath	MALE
chandrani	FEMALE
chandraraj	MALE
chandrashekar	MALE
chandrashekhar	MALE
chandresh	MALE
chandrika	FEMALE
chandrima	FEMALE
changbeom	MALE
changhee	MALE
changki	MALE
changning	MALE
changuna	FEMALE
chao-jan	MALE
chaomei	MALE
chapal	MALE
chapala	FEMALE
charan	MALE
charanjit	MALE
charibeth	FEMALE
charita	FEMALE
charl	MALE
charles	MALE
charu	FEMALE
charudutta	MALE
charulata	FEMALE
charulekha	FEMALE
charumati	FEMALE
charuprabha	FEMALE
charusheela	FEMALE
charusmita	FEMALE
charvi	FEMALE
chashmum	FEMALE
chatresh	MALE
chatura	FEMALE
chatura	MALE
chaturbhuj	MALE
cheng-der	MALE
chengqing	MALE
cheoljung	MALE
cheshta	FEMALE
chetan	MALE
chetana	MALE
chetna	FEMALE
cheyenne	FEMALE
chhabi	FEMALE
chhandak	MALE
chhatrabhuj	MALE
chhavi	FEMALE
chhavvi	FEMALE
chhaya	FEMALE
chi-hoon	MALE
chiaki	FEMALE
chiara	FEMALE
chiasa	FEMALE
chidambar	MALE
chidanand	MALE
chidananda	MALE
chie	FEMALE
chieko	FEMALE
chiharu	FEMALE
chika	FEMALE
chikafusa	MALE
chikako	FEMALE
chikao	MALE
chikara	FEMALE
chikashi	MALE
chikku	MALE
chiko	FEMALE
chiko	MALE
chikuma	FEMALE
chilin	FEMALE
chiman	MALE
chimato	MALE
chimayi	FEMALE
chin-chuan	MALE
chin-hui	MALE
chin-yew	MALE
chinatsu	FEMALE
chinkoo	MALE
chinmay	MALE
chinmayananda	MALE
chinmayi	FEMALE
chinmayu	MALE
chinnu	FEMALE
chintamani	MALE
chintan	MALE
chintan;	FEMALE
chintanika	FEMALE
chiori	FEMALE
chirag	MALE
chiranjeev	MALE
chiranjiv	MALE
chirantan	MALE
chirayu	MALE
chisato	FEMALE
chitesh	MALE
chiti	FEMALE
chitkala	FEMALE
chitose	FEMALE
chitra	FEMALE
chitrabhanu	MALE
chitragandha	FEMALE
chitraksh	MALE
chitral	MALE
chitralekha	FEMALE
chitrali	FEMALE
chitramala	FEMALE
chitrangada	FEMALE
chitrani	FEMALE
chitrarath	MALE
chitrarekha	FEMALE
chitrasen	MALE
chitresh	MALE
chitrita	FEMALE
chitt	MALE
chitta	MALE
chittaprasad	MALE
chittaranjan	MALE
chittaswarup	MALE
chittesh	MALE
chiyeko	FEMALE
chiyo	FEMALE
chiyoko	FEMALE
chiyomi	FEMALE
cho	FEMALE
chojiro	MALE
chomei	MALE
chong woo	MALE
choong-nyoung	MALE
chou	FEMALE
chouko	FEMALE
chris	MALE
chrisitta	FEMALE
christelle	FEMALE
christer	MALE
christina	FEMALE
christof	MALE
christoph	MALE
christophe	MALE
christos	MALE
chrysanne	FEMALE
chu-ren	MALE
chudamani	MALE
chuichi	MALE
chul-min	MALE
chun-hung	MALE
chunni	FEMALE
chutima	FEMALE
cilji	FEMALE
cinzia	FEMALE
ciprian	MALE
clarisse	FEMALE
claus	MALE
clemens	MALE
clive	MALE
cole	MALE
conor	MALE
constantin	MALE
constantine	MALE
constantinos	MALE
constatin	MALE
cortis	MALE
coshel	MALE
cosmin	MALE
craige	FEMALE
cristian	MALE
cristiano	MALE
crit	MALE
csaba	MALE
cvetana	FEMALE
czaee	FEMALE
d&#233	MALE
d?niel	MALE
daan	MALE
dabeet	MALE
dafydd	MALE
dag	MALE
dai	FEMALE
dai	MALE
daichi	MALE
daiga	FEMALE
daiki	MALE
daisetsu	MALE
daisuke	MALE
daiwik	MALE
dakotah	MALE
daksha	FEMALE
dakshata	FEMALE
dakshayani	FEMALE
dakshesh	MALE
dakshi	MALE
dalaja	FEMALE
daman	MALE
damayanti	FEMALE
damian	MALE
damianos	MALE
damini	FEMALE
damir	MALE
damodar	MALE
damyanti	FEMALE
danish	MALE
danjuro	MALE
danna	FEMALE
danno	MALE
danushka	MALE
danvir	MALE
daoud	MALE
darika	FEMALE
darja	FEMALE
darl	MALE
darpad	MALE
darpak	MALE
darpan	MALE
darpana	FEMALE
darsh	MALE
darshan	MALE
darshana	FEMALE
darshwana	FEMALE
daruka	MALE
daryl	MALE
dasharath	MALE
dasharathi	MALE
dashtseren	MALE
dattatreya	MALE
davide	MALE
davood	MALE
davy	MALE
dawei	MALE
dawoud	MALE
daya	FEMALE
dayakar	MALE
dayamayee	FEMALE
dayamayi	FEMALE
dayanand	MALE
dayanita	FEMALE
dayaram	MALE
dayashankar	MALE
dayita	FEMALE
dayne	MALE
dayu	MALE
debaditya	MALE
debashis	MALE
debashish	MALE
debasri	FEMALE
debbie	FEMALE
debjit	MALE
declan	MALE
dedre	FEMALE
deeba	FEMALE
deenabandhu	MALE
deep	MALE
deepa	FEMALE
deepabali	FEMALE
deepak	MALE
deepal	FEMALE
deepali	FEMALE
deepamala	FEMALE
deepan	MALE
deepankar	MALE
deepanwita	FEMALE
deepaprabha	FEMALE
deepashikha	FEMALE
deepavali	FEMALE
deepen	MALE
deependra	MALE
deependu	MALE
deepesh	MALE
deepika	FEMALE
deepit	MALE
deepjyoti	FEMALE
deepmala	FEMALE
deepshika	FEMALE
deepta	FEMALE
deeptanshu	MALE
deeptendu	MALE
deepthi	FEMALE
deepti	FEMALE
deeptikana	FEMALE
deeptiman	MALE
deeptimoy	MALE
deeptimoyee	FEMALE
dekai	MALE
dekang	MALE
delip	MALE
delisha	FEMALE
demetrios	MALE
demitrios	MALE
denbe	MALE
deniz	MALE
denys	MALE
deok-bong	MALE
deshnee	FEMALE
desiha	FEMALE
detmar	MALE
dev	MALE
devabrata	MALE
devadas	MALE
devadutt	MALE
devahuti	FEMALE
devaj	MALE
devajyoti	MALE
devak	FEMALE
devak	MALE
devaki	FEMALE
devan	MALE
devanand	MALE
devang	MALE
devangana	FEMALE
devangi	FEMALE
devank	MALE
devansh	MALE
devanshi	FEMALE
devarshi	MALE
devarsi	MALE
devashree	FEMALE
devasree	FEMALE
devbrata	MALE
devdarsh	MALE
devdas	MALE
devdatta	MALE
devdutta	MALE
deven	MALE
devendra	MALE
devesh	MALE
deveshi	FEMALE
deveshwar	MALE
devi	FEMALE
devika	FEMALE
devilal	MALE
devin	MALE
devina	FEMALE
deviprasad	MALE
devishi	FEMALE
devkanya	FEMALE
devki	FEMALE
devkumar	MALE
devlan	MALE
devmani	FEMALE
devnarayan	MALE
devnath	MALE
devpad	MALE
devraj	MALE
devrat	MALE
devyani	FEMALE
dhairya	MALE
dhananjay	MALE
dhanashri	FEMALE
dhanesh	MALE
dhanishta	FEMALE
dhanraj	MALE
dhansukh	MALE
dhanvant	MALE
dhanvanti	FEMALE
dhanvin	MALE
dhanya	FEMALE
dhanyata	FEMALE
dhara	FEMALE
dharani	FEMALE
dharanidhar	MALE
dharini	FEMALE
dharitri	FEMALE
dharma	MALE
dharmadas	MALE
dharmadev	MALE
dharmanand	MALE
dharmendra	MALE
dharmendu	MALE
dharmesh	MALE
dharmi	MALE
dharmpal	MALE
dharmveer	MALE
dharti	FEMALE
dhatri	FEMALE
dhaval	MALE
dhawal	MALE
dheeman	MALE
dheemant	MALE
dheeptha	FEMALE
dheer	MALE
dheerendra	MALE
dhilan	MALE
dhimant	MALE
dhir	MALE
dhiraj	MALE
dhiren	MALE
dhirendra	MALE
dhriti	FEMALE
dhritiman	MALE
dhrubajyoti	MALE
dhrupad	MALE
dhruti	FEMALE
dhruv	MALE
dhruva	FEMALE
dhruva	MALE
dhruvi	FEMALE
dhuha	FEMALE
dhul	MALE
dhvani	FEMALE
dhwani	FEMALE
dhwani	MALE
dhyana	FEMALE
dhyanesh	MALE
diamantino	MALE
diarmuid	MALE
didier	MALE
dieter	MALE
dietmar	MALE
dietrich	MALE
digamber	MALE
digvi	FEMALE
digvijay	MALE
dijul	MALE
diksha	FEMALE
dilan	FEMALE
dilawar	MALE
dilber	FEMALE
dilek	FEMALE
dilip	MALE
dilshad	FEMALE
dimitar	MALE
dimitra	FEMALE
dimitrios	MALE
dimitris	MALE
dimitry	MALE
dimple	FEMALE
dinanath	MALE
dinar	MALE
dindayal	MALE
dinesh	MALE
dinkar	MALE
dipali	FEMALE
dipanjan	MALE
dipankar	MALE
dipashri	FEMALE
dipendu	MALE
dipesh	MALE
diptanshu	MALE
dipti	FEMALE
dipu	MALE
disha	FEMALE
dishita	FEMALE
diti	FEMALE
dityaa	MALE
diva	FEMALE
divakar	MALE
divij	MALE
divija	FEMALE
divita	FEMALE
divya	FEMALE
divyanga	MALE
divyanshu	MALE
divyata	FEMALE
divyendu	MALE
divyesh	MALE
diya	FEMALE
diyaa	MALE
dmitri	MALE
dmitriy	MALE
dmitry	MALE
do-gil	MALE
do-sang	MALE
dogan	MALE
doi	MALE
dokuohtei	MALE
dolma	FEMALE
dolon	FEMALE
dolors	FEMALE
domenico	MALE
domenyk	MALE
dominiek	MALE
dominik	MALE
dona	FEMALE
dong-hee	MALE
dong-il	MALE
dong-in	MALE
dong-won	MALE
dongdong	FEMALE
donghyun	MALE
dongmo	FEMALE
dongwon	MALE
donia	FEMALE
donie	MALE
doppo	MALE
doroteo	MALE
dorothee	FEMALE
dorry	MALE
dorte	FEMALE
doyel	FEMALE
dragomir	MALE
drahom&#237	MALE
drahom??ra	FEMALE
drahomir	MALE
drahomira	FEMALE
draupadi	FEMALE
dravie	FEMALE
drewv	MALE
drishti	FEMALE
drishya	FEMALE
driss	MALE
dristi	FEMALE
dror	MALE
drupad	MALE
duane	MALE
dulal	MALE
dulari	FEMALE
dumisizwe	MALE
dunstan	MALE
duranjaya	MALE
durba	FEMALE
durga	FEMALE
durijesh	MALE
durjaya	MALE
durva	FEMALE
dushyant	MALE
dushyanta	MALE
dvita	FEMALE
dwaipayan	MALE
dwij	MALE
dwijain	MALE
dwijaraj	MALE
dwijendra	MALE
dwijesh	MALE
dwipavati	FEMALE
dwisha	FEMALE
dyumani	MALE
dyumna	FEMALE
dyuti	FEMALE
eamonn	MALE
eashta	FEMALE
easmatara	FEMALE
ebadaah	MALE
eberhard	MALE
ebizo	MALE
ebru	FEMALE
ecchumati	FEMALE
echiko	FEMALE
eckhard	MALE
edha	FEMALE
edi	MALE
ednit	MALE
edouard	MALE
eduard	MALE
eero	MALE
eesha	FEMALE
eeshika	FEMALE
eeshwar	MALE
efrat	FEMALE
efstathios	MALE
egidio	MALE
egoitz	MALE
egon	MALE
eha	MALE
ehimay	MALE
ehud	MALE
eibe	MALE
eichi	MALE
eichiro	MALE
eien	MALE
eiichi	MALE
eiji	MALE
eijiro	MALE
eikichi	MALE
eiko	FEMALE
eila	FEMALE
einat	FEMALE
einav	MALE
eirini	FEMALE
eisaku	MALE
eisen	MALE
eishi	MALE
eisuke	MALE
eitaro	MALE
eitoku	MALE
eizan	MALE
eizo	MALE
eka	MALE
ekaa	FEMALE
ekadant	MALE
ekagrah	MALE
ekaja	FEMALE
ekaksha	MALE
ekalavya	MALE
ekaling	MALE
ekalinga	MALE
ekambar	MALE
ekana	MALE
ekanath	MALE
ekanga	MALE
ekani	FEMALE
ekansh	MALE
ekanta	FEMALE
ekantika	FEMALE
ekapad	MALE
ekaparana	FEMALE
ekaraj	MALE
ekata	FEMALE
ekaterina	FEMALE
ekatherini	FEMALE
ekavali	FEMALE
ekavir	MALE
ekavira	MALE
ekbal	MALE
ekiken	MALE
eknath	MALE
ekram	MALE
ekta	FEMALE
ektaa	FEMALE
el-sayed	MALE
ela	FEMALE
elad	MALE
elaro	FEMALE
elavarasan	MALE
eleazar	MALE
eleftherios	MALE
eleonora	FEMALE
eliezer	MALE
elif	FEMALE
elina	FEMALE
eline	FEMALE
elisabeitta	FEMALE
elisabet	FEMALE
elisabeta	FEMALE
elisabete	FEMALE
elisabetta	FEMALE
elixabete	FEMALE
elizabeth	FEMALE
ellora	FEMALE
elmar	MALE
els	FEMALE
elsa	FEMALE
elsab&#233	FEMALE
elsi	FEMALE
elyes	MALE
elzbieta	FEMALE
ema	FEMALE
emaan	MALE
emanuela	FEMALE
emerald	FEMALE
emese	FEMALE
emi	FEMALE
emiel	MALE
emiko	FEMALE
emiliano	MALE
emine	FEMALE
emma	FEMALE
emmanuelle	FEMALE
enakshi	FEMALE
eneko	MALE
enes	MALE
eniko	FEMALE
ennosuke	MALE
enrico	MALE
epshita	FEMALE
ergin	MALE
ergun	MALE
erhard	MALE
eri	FEMALE
eriko	FEMALE
erin	FEMALE
ernst	MALE
esha	FEMALE
eshana	FEMALE
eshita	FEMALE
eshwar	MALE
esref	MALE
estevam	MALE
estibaliz	MALE
eszter	FEMALE
eta	FEMALE
etash	MALE
etienne	MALE
etsuko	FEMALE
etsuya	MALE
euiko	FEMALE
eunju	FEMALE
eva	FEMALE
evadne	FEMALE
evandro	MALE
evangelin	FEMALE
evangelos	MALE
evgeniy	MALE
evgeny	MALE
evguenia	FEMALE
evi	FEMALE
evyavan	MALE
ewa	FEMALE
ewan	MALE
eyal	MALE
faakhir	MALE
faaris	MALE
faarooq	MALE
faatin	FEMALE
faatina	FEMALE
fabien	MALE
fabienne	FEMALE
fabio	MALE
fabre	MALE
fabrice	MALE
fabrizio	MALE
fadheela	FEMALE
fadi	MALE
fadl	MALE
fadwa	FEMALE
fahad	MALE
faisal	MALE
faith	FEMALE
faiyaz	MALE
faiz	MALE
faiza	FEMALE
faizan	MALE
fajyaz	FEMALE
fakhry	MALE
falak	FEMALE
falak	MALE
falgu	MALE
falguni	FEMALE
falguni	MALE
fanibhusan	MALE
fanibhushan	MALE
fanindra	MALE
fanish	MALE
fanishwar	MALE
farah	FEMALE
faraz	MALE
fardden	MALE
fareed	MALE
fareeda	FEMALE
fareeha	FEMALE
farha	FEMALE
farhad	MALE
farhana	FEMALE
farhat	FEMALE
farhat	MALE
faria	FEMALE
farid	MALE
farida	FEMALE
faris	MALE
farokh	MALE
farooq	MALE
farzad	MALE
farzana	FEMALE
farzaneh	FEMALE
farzin	FEMALE
fateen	MALE
fateh	MALE
fatih	MALE
fatik	MALE
fatima	FEMALE
fatimah	FEMALE
fawad	MALE
fawaz	MALE
fawiza	FEMALE
fawziya	FEMALE
fazel	MALE
fazil	MALE
federica	FEMALE
feikje	FEMALE
fenal	FEMALE
ferenc	MALE
fergus	MALE
ferin	FEMALE
fernand	MALE
feroz	MALE
fiammetta	FEMALE
fidaa	MALE
fidelia	FEMALE
fien	MALE
fileno	MALE
filip	MALE
filipe	MALE
filza	FEMALE
finley	MALE
finn	MALE
fintan	MALE
firdaus	MALE
firdoos	FEMALE
firoz	MALE
firoza	FEMALE
firyal	FEMALE
fiza	FEMALE
fizza	FEMALE
flavio	MALE
florian	MALE
florin	MALE
folkert	MALE
fons	MALE
foolan	FEMALE
foolwati	FEMALE
foram	FEMALE
forum	FEMALE
fr?d?ric	MALE
fran??ois	MALE
fran?ois	MALE
franca	FEMALE
francesc	MALE
francine	FEMALE
francis	MALE
franciska	FEMALE
francisko	MALE
franck	MALE
franco	MALE
francois	MALE
francois-michel	MALE
francois-regis	MALE
francoise	FEMALE
frantz	MALE
franz	MALE
fravash	MALE
frederik	MALE
frederique	MALE
fredrik	MALE
frida	FEMALE
friedhelm	MALE
friedrich	MALE
fuad	MALE
fuji	FEMALE
fujiko	FEMALE
fujimaro	MALE
fujio	MALE
fukusaburu	MALE
fuliang	MALE
fulki	FEMALE
fullan	FEMALE
fullara	FEMALE
fulmala	FEMALE
fumi	FEMALE
fumiaki	MALE
fumie	FEMALE
fumihiko	MALE
fumihiro	MALE
fumihito	MALE
fumiki	FEMALE
fumiko	FEMALE
fumimaro	MALE
fuminori	MALE
fumio	MALE
fumito	MALE
fumiyo	FEMALE
fumiyuki	MALE
fusae	FEMALE
futoshi	MALE
fuyuko	FEMALE
g?bor	MALE
g?nter	MALE
g?nther	MALE
g?raldine	FEMALE
gabe	MALE
gabor	MALE
gadin	MALE
gael	MALE
gagan	MALE
gaganvihari	MALE
gagnesh	MALE
gaho	MALE
gaja	FEMALE
gajagamini	FEMALE
gajanan	MALE
gajanand	MALE
gajendra	MALE
gajra	FEMALE
gajrup	MALE
gakuto	MALE
galav	MALE
galia	FEMALE
galileo	MALE
galina	FEMALE
ganapati	MALE
ganaraj	MALE
gandhali	FEMALE
gandharva	MALE
gandhi	MALE
gandhik	MALE
ganesh	MALE
ganga	FEMALE
gangadhar	MALE
gangadutt	MALE
gangesh	MALE
gangeya	MALE
gangika	FEMALE
gangol	MALE
gangotri	FEMALE
ganika	FEMALE
ganjan	FEMALE
gann	MALE
gareth	MALE
gargi	FEMALE
garima	FEMALE
garrison	MALE
garry	MALE
gatita	FEMALE
gauhar	FEMALE
gaura	FEMALE
gaurang	MALE
gaurav	MALE
gauri	FEMALE
gaurika	FEMALE
gaurinath	MALE
gautam	MALE
gautami	FEMALE
gayatri	FEMALE
gazala	FEMALE
geena	FEMALE
geert	MALE
geert-jan	MALE
geet	FEMALE
geet	MALE
geeta	FEMALE
geetha	FEMALE
geeti	FEMALE
geetika	FEMALE
gehna	FEMALE
gekko	MALE
gemmei	FEMALE
gempachi	MALE
gen	FEMALE
gen-itiro	MALE
gengyo	MALE
genichi	MALE
genichiro	MALE
genjo	MALE
gennai	MALE
gennosuke	MALE
genpaku	MALE
georg	MALE
georges	MALE
georgi	MALE
georgios	MALE
gerasimos	MALE
gerd	MALE
gerh.	MALE
gerhard	MALE
germ?n	MALE
gerrit	MALE
gert	MALE
gertjan	MALE
gesshin	MALE
geunbae	MALE
ghaada	FEMALE
ghaalib	MALE
ghaaliya	FEMALE
ghaazi	MALE
ghanashyam	MALE
ghanshyam	MALE
ghasaan	MALE
ghaydaa	FEMALE
ghazal	FEMALE
ghazi	MALE
gheorghe	MALE
ghiyaath	MALE
gholamreza	MALE
ghusoon	FEMALE
giacomo	MALE
giampaolo	MALE
gian	MALE
giancarlo	MALE
gianender	MALE
gianluca	MALE
gianmaria	MALE
gianni	MALE
gidayu	MALE
gideon	MALE
gihei	MALE
giichi	MALE
gilad	MALE
gilchang	MALE
gilles	MALE
gilles-maurice	MALE
gin	FEMALE
gina	FEMALE
gina-anne	FEMALE
ginko	FEMALE
ginni	FEMALE
giorgio	MALE
giorgos	MALE
gira	FEMALE
girdhari	MALE
giri	MALE
giribala	FEMALE
giridari	MALE
giridhar	MALE
girija	FEMALE
girik	MALE
girilal	MALE
girindra	MALE
giriraj	MALE
girish	MALE
girisha	FEMALE
girivar	MALE
gisele	FEMALE
gita	FEMALE
gitali	FEMALE
gitanjali	FEMALE
gitashri	FEMALE
gitesh	MALE
gitika	FEMALE
giulia	FEMALE
go	MALE
godavari	FEMALE
godavri	FEMALE
goemon	MALE
gokhan	MALE
gokturk	MALE
gokul	MALE
goldy	FEMALE
gomati	FEMALE
gombei	MALE
gomti	FEMALE
gonkuro	MALE
gonnohyoe	MALE
gonshiro	MALE
gool	FEMALE
gopa	FEMALE
gopal	MALE
gopan	MALE
gopesh	MALE
gopi	FEMALE
gopichand	MALE
gopika	FEMALE
gorakh	MALE
goraksh	MALE
goral	MALE
goran	MALE
gorav	MALE
gori	FEMALE
gorma	FEMALE
goro	MALE
gorochana	FEMALE
gorou	MALE
gosse	MALE
gourishankar	MALE
goutheesh	MALE
govind	MALE
govinda	MALE
govindaraj	MALE
govindi	FEMALE
graca	FEMALE
graeme	MALE
granthana	FEMALE
graziella	FEMALE
grazyna	FEMALE
greashma	FEMALE
gregers	MALE
gregoire	MALE
gregor	MALE
greville	MALE
grishm	MALE
grishma	FEMALE
grzegorz	MALE
gudakesha	MALE
guenter	MALE
guenther	MALE
guergana	FEMALE
guido	MALE
guillaume	MALE
gul	FEMALE
gul	MALE
gulab	FEMALE
gulab	MALE
gulal	MALE
gulfam	MALE
gulika	FEMALE
gully	MALE
gulsen	FEMALE
gulzar	MALE
gulzarilal	MALE
gumwant	MALE
gunaja	MALE
gunamay	MALE
gunaratna	MALE
guneet	FEMALE
gunin	MALE
gunita	FEMALE
gunjan	FEMALE
gunjan	MALE
gunjana	FEMALE
gunnar	MALE
gunnel	FEMALE
gunnika	FEMALE
gunter	MALE
gunther	MALE
gunvant	MALE
gunwanti	FEMALE
guo-wei	MALE
gupil	MALE
gurbachan	MALE
gurbani	FEMALE
gurcharan	MALE
gurdayal	MALE
gurdeep	MALE
gurjari	FEMALE
gurman	MALE
gurmeet	MALE
gurnam	MALE
gurpreet	MALE
gurraj	MALE
gursharan	MALE
gurson	MALE
guru	MALE
gurudas	MALE
gurudatt	MALE
gurudutt	MALE
gustav	MALE
guvid	MALE
gwyneth	FEMALE
gy?rgy	MALE
gyan	MALE
gyanada	FEMALE
gyokusho	MALE
gyukudo	MALE
h?l?ne	FEMALE
haadiya	FEMALE
haady	MALE
haakon	MALE
haala	FEMALE
haamid	MALE
haani	MALE
haarith	MALE
haaroon	MALE
haashim	MALE
haatim	MALE
habib	MALE
habiba	FEMALE
hachemon	MALE
hachigoro	MALE
hachiro	MALE
hadar	MALE
hadhemi	FEMALE
hadiya	FEMALE
haejoong	MALE
hafiz	MALE
hafiza	FEMALE
hagen	MALE
haifa	FEMALE
haifeng	MALE
hailley	FEMALE
haima	FEMALE
haimavati	FEMALE
haimi	FEMALE
haizhou	MALE
hajime	MALE
hakan	MALE
hakesh	MALE
hakimeh	FEMALE
hakoto	MALE
hakuseki	MALE
haldur	MALE
haleema	FEMALE
halil	MALE
hama	FEMALE
hamed	MALE
hameeda	FEMALE
hamid	MALE
hamir	MALE
hamish	MALE
hammad	MALE
hammam	MALE
hamsa	FEMALE
hamsini	FEMALE
hamza	MALE
han-cheol	MALE
han-min	MALE
hana	FEMALE
hanae	FEMALE
hanako	FEMALE
hanan	FEMALE
haneefa	FEMALE
hani	MALE
hanife	FEMALE
haniko	FEMALE
hanima	FEMALE
hanisha	FEMALE
haniya	FEMALE
hanmin	MALE
hannah	FEMALE
hanne	FEMALE
hannes	MALE
hanno	MALE
hans	MALE
hans-joachim	MALE
hans-peter	MALE
hans-ulrich	MALE
hansa	FEMALE
hanshiro	MALE
hansika	FEMALE
hansini	FEMALE
hansj?rg	MALE
hansraj	MALE
hansuja	FEMALE
hanuman	MALE
hanumant	MALE
hany	MALE
harald	MALE
haranobu	MALE
harathi	FEMALE
hardeep	MALE
hardik	MALE
harekrishna	MALE
harendra	MALE
haresh	MALE
hari	FEMALE
hari	MALE
hariaksa	MALE
haribala	FEMALE
haridas	MALE
harigopal	MALE
harihar	MALE
harij	MALE
harika	FEMALE
harikrishna	MALE
harilal	MALE
harimanti	FEMALE
harinakshi	FEMALE
harinarayan	MALE
harindra	MALE
harini	FEMALE
hariom	MALE
hariprasad	MALE
haripreet	MALE
haripriya	FEMALE
hariram	MALE
haris	MALE
harish	MALE
harishankar	MALE
harishchandra	MALE
harita	FEMALE
haritbaran	MALE
harithik	MALE
harjas	FEMALE
harjas	MALE
harjeet	MALE
harjit	MALE
harkrishna	MALE
harksoo	MALE
harleena	FEMALE
harm	MALE
harmendra	MALE
haroon	MALE
harr	MALE
harri	MALE
harsh	MALE
harsha	FEMALE
harsha	MALE
harshad	MALE
harshada	FEMALE
harshal	FEMALE
harshal	MALE
harshavardhan	MALE
harshi	FEMALE
harshil	MALE
harshini	FEMALE
harshit	MALE
harshita	FEMALE
harshita	MALE
harshul	MALE
harshvardhan	MALE
harsika	FEMALE
haru	FEMALE
haru	MALE
haruhiko	MALE
haruhiro	MALE
haruka	FEMALE
haruki	FEMALE
haruki	MALE
harukichi	FEMALE
haruko	FEMALE
haruko	MALE
harumi	FEMALE
harumi	MALE
haruna	FEMALE
harunobu	MALE
haruo	MALE
haruto	MALE
hasan	MALE
hashmat	MALE
hasina	FEMALE
hasit	MALE
hasita	FEMALE
hasmukh	MALE
hasna	FEMALE
hassan	MALE
hasumati	FEMALE
hataf	MALE
hatem	MALE
hatsue	FEMALE
hatsuyo	FEMALE
hayaam	FEMALE
hayat	FEMALE
hayate	MALE
hayato	MALE
haytham	MALE
hayward	MALE
hazrat	MALE
hebert	MALE
hee-cheol	MALE
heejin	FEMALE
heer	MALE
heera	FEMALE
heihachiro	MALE
heiji	MALE
heike	FEMALE
heiki	MALE
heiki jaan	MALE
heiki-jaan	MALE
heikichi	MALE
heinz	MALE
heinz-dirk	MALE
heizo	MALE
hela	FEMALE
helana	FEMALE
helder	MALE
helena	FEMALE
helge	MALE
helmut	MALE
hem	MALE
hema	FEMALE
hemachandra	MALE
hemadri	FEMALE
hemadri	MALE
hemakesh	MALE
hemakshi	FEMALE
hemal	FEMALE
hemal	MALE
hemali	FEMALE
hemamdar	MALE
hemang	MALE
hemanga	MALE
hemangi	FEMALE
hemangini	FEMALE
hemani	FEMALE
hemant	MALE
hemanta	MALE
hemanti	FEMALE
hemaraj	MALE
hemavati	FEMALE
hemdev	MALE
hemen	MALE
hemendra	MALE
hemendu	MALE
hemish	MALE
hemisha	FEMALE
hemlata	FEMALE
hemraj	MALE
hems	MALE
hena	FEMALE
hendrik	MALE
henk	MALE
henna	FEMALE
hennie	MALE
henrik	MALE
heramb	MALE
heramba	MALE
hercules	MALE
hermann	MALE
herv	MALE
herv&#225	MALE
herv?	MALE
herve	MALE
herwig	MALE
hessa	FEMALE
het	FEMALE
het	MALE
hetal	FEMALE
heti	FEMALE
heui-seok	MALE
hiba	FEMALE
hibah	FEMALE
hibiki	MALE
hide	FEMALE
hideaki	MALE
hideharu	MALE
hidehiko	MALE
hidehira	MALE
hidekazu	MALE
hideki	MALE
hideko	FEMALE
hidemichi	MALE
hideo	MALE
hidetada	MALE
hidetaka	MALE
hideto	MALE
hidetora	MALE
hidetoshi	MALE
hidetsugu	MALE
hideya	MALE
hideyori	MALE
hideyoshi	MALE
hideyuki	MALE
higashikuni	MALE
hikari	FEMALE
hikaru	FEMALE
hikaru	MALE
hikosaburo	MALE
hikozaemon	MALE
hili	FEMALE
hilla	FEMALE
hima	FEMALE
himachal	MALE
himadri	MALE
himaghna	MALE
himagouri	FEMALE
himaja	FEMALE
himalay	MALE
himani	FEMALE
himanish	MALE
himank	FEMALE
himanshu	MALE
himmat	MALE
himnish	MALE
hina	FEMALE
hinal	FEMALE
hind	FEMALE
hindola	FEMALE
hinrich	MALE
hira	MALE
hiraku	MALE
hiral	FEMALE
hirankshi	FEMALE
hiranmay	MALE
hiranmayi	FEMALE
hiranya	MALE
hiren	MALE
hirendra	MALE
hiresh	MALE
hirkani	FEMALE
hiro	MALE
hiroaki	MALE
hirobumi	MALE
hiroe	FEMALE
hirofumi	MALE
hiroharu	MALE
hirohiko	MALE
hirohisa	MALE
hirohumi	MALE
hiroji	MALE
hirokazu	MALE
hiroki	MALE
hirokichi	MALE
hiroko	FEMALE
hirokumi	MALE
hiromi	FEMALE
hiromichi	MALE
hiromitsu	MALE
hironori	MALE
hirosato	MALE
hiroshi	MALE
hiroshige	MALE
hirosi	MALE
hirotada	MALE
hirotaka	MALE
hiroto	MALE
hirotoshi	MALE
hirotsugu	MALE
hiroya	MALE
hiroyasu	MALE
hiroyuki	MALE
hisa	FEMALE
hisae	FEMALE
hisahiro	MALE
hisahsi	MALE
hisaki	MALE
hisako	FEMALE
hisami	FEMALE
hisamitsu	MALE
hisano	FEMALE
hisanobu	MALE
hisao	MALE
hisashi	MALE
hisato	MALE
hisayuki	MALE
hisham	MALE
hita	FEMALE
hitaishi	FEMALE
hitansi	FEMALE
hitee	FEMALE
hiten	MALE
hitendra	MALE
hitesh	MALE
hitesha	FEMALE
hitham	MALE
hitomaro	MALE
hitomi	FEMALE
hitomo	FEMALE
hitoshi	MALE
hiya	FEMALE
hiyan	MALE
hmoud	MALE
hodong	MALE
hogai	MALE
hoifung	MALE
hoitsu	MALE
hokichi	MALE
hokusai	MALE
holger	MALE
holland	MALE
holmer	MALE
homa	FEMALE
honami	FEMALE
honda	MALE
honey	FEMALE
hong-woo	MALE
honglin	MALE
hongyan	FEMALE
honnesha	FEMALE
honoka	FEMALE
honzo	MALE
hoor	FEMALE
hooriya	FEMALE
horiuchi	MALE
horng	MALE
horst	MALE
horst-udo	MALE
hoshi	FEMALE
hoshi	MALE
hoshie	FEMALE
hoshiko	FEMALE
hoshiko	MALE
hoshiyo	FEMALE
hossam	MALE
hotaka	MALE
hotaru	FEMALE
houd	MALE
houfeng	MALE
houssem	MALE
hozumi	MALE
hradini	FEMALE
hriday	MALE
hridayesh	MALE
hridaynath	MALE
hridyesha	FEMALE
hrishi	MALE
hrishikesh	MALE
hristo	MALE
hrithvik	MALE
hritik	MALE
hritika	FEMALE
hritvi	FEMALE
hryday	MALE
hrydayesh	MALE
hsin-hsi	MALE
huda	FEMALE
hui-feng	FEMALE
huibin	FEMALE
huifeng	FEMALE
huihsin	FEMALE
huijia	FEMALE
huipeng	FEMALE
huisheng	FEMALE
huiyong	FEMALE
huizhen	FEMALE
huizhong	FEMALE
huma	FEMALE
humaid	MALE
humaila	FEMALE
humaithi	MALE
humam	MALE
humphrey	MALE
hunar	MALE
hunil	MALE
husaam	MALE
husein	MALE
husn	FEMALE
husna	FEMALE
husnain	MALE
hussain	MALE
hussein	MALE
hussny	MALE
hutchatai	FEMALE
huthayfa	MALE
huvishka	FEMALE
huy	MALE
hwee tou	MALE
hy	MALE
hye-jin	FEMALE
hyeon-jin	MALE
hyo-jung	FEMALE
hyobe	MALE
hyopil	MALE
hyosuke	MALE
hyotaru	MALE
hyouk	MALE
hyouk-keun	MALE
hyoung-gyu	MALE
hyuckchul	MALE
hyuk-chul	MALE
hyukro	MALE
hyung joon	MALE
hyungbae	MALE
hyunjo	MALE
hyunjung	FEMALE
iain	MALE
ibhanan	MALE
ibraheem	MALE
ibrahim	MALE
ibtihaaj	FEMALE
ichi	FEMALE
ichibei	MALE
ichikawa	MALE
ichiro	MALE
ichirou	MALE
ichisake	MALE
ichiyo	MALE
ichizo	MALE
idaspati	MALE
iddo	MALE
idha	FEMALE
idhant	MALE
idika	FEMALE
iditri	FEMALE
ido	MALE
idrees	MALE
idris	MALE
ielka	FEMALE
iemitsu	MALE
iemochi	MALE
ienobu	MALE
iesa	MALE
iesada	MALE
ieshige	MALE
ietsuna	MALE
ieyasu	MALE
ieyoshi	MALE
igal	MALE
ignasi	MALE
igor	MALE
iha	FEMALE
iham	MALE
ihina	FEMALE
ihit	MALE
ihita	FEMALE
ihsaan	MALE
ijay	MALE
ijaya	FEMALE
ikemoto	MALE
iker	MALE
ikki	MALE
ikku	MALE
ikraam	FEMALE
ikrimah	MALE
iksha	FEMALE
ikshan	MALE
ikshita	FEMALE
ikshu	FEMALE
ikshu	MALE
ikshula	FEMALE
iku	FEMALE
ikue	FEMALE
ikuko	FEMALE
ikuo	MALE
ila	FEMALE
ilarion	MALE
ilashpasti	MALE
ilesh	MALE
ilhaam	FEMALE
ilisa	MALE
ilknur	FEMALE
ilko	MALE
illisha	FEMALE
ilyas	MALE
imaad	MALE
imad	MALE
iman	FEMALE
iman	MALE
imaran	MALE
imdad	MALE
imraan	MALE
imtiaz	MALE
imtithal	FEMALE
imtiyaz	MALE
in-ho	MALE
ina	FEMALE
inaam	FEMALE
inari	FEMALE
inas	FEMALE
inas	MALE
inaya	FEMALE
inayat	FEMALE
indali	FEMALE
indeever	MALE
inderjeet	MALE
indira	FEMALE
indivar	MALE
indra	MALE
indradutt	MALE
indrajeet	MALE
indrajit	MALE
indrakanta	MALE
indrakshi	FEMALE
indraneel	MALE
indrani	FEMALE
indrasena	FEMALE
indravadan	MALE
indrayani	FEMALE
indu	FEMALE
indubhushan	MALE
induhasan	MALE
induja	FEMALE
indukala	FEMALE
indukanta	MALE
indulal	MALE
indulekha	FEMALE
induleksh	FEMALE
induma	FEMALE
indumal	MALE
indumati	FEMALE
indumukhi	FEMALE
indushekhar	MALE
inejiro	MALE
inesh	MALE
ingo	MALE
inguna	FEMALE
ingunn	FEMALE
inika	FEMALE
inmaculada	FEMALE
inoday	MALE
inoue	FEMALE
insup	MALE
intekhab	MALE
intisaar	FEMALE
inu	FEMALE
ioannis	MALE
ion	MALE
iona	FEMALE
iosif	MALE
ipil	MALE
ippei	MALE
ipsa	FEMALE
ipsita	FEMALE
iqbal	MALE
iraj	MALE
iraja	FEMALE
iravan	MALE
iravat	MALE
iravati	FEMALE
irenpreet	MALE
irfaan	MALE
irfan	MALE
irine	FEMALE
iris	FEMALE
irshaad	MALE
iryna	FEMALE
is-haaq	MALE
isaam	MALE
isabeile	FEMALE
isako	FEMALE
isamu	MALE
isao	MALE
isar	MALE
ise	FEMALE
isei	MALE
ish	MALE
isha	FEMALE
ishaan	MALE
ishan	MALE
ishana	FEMALE
ishani	FEMALE
ishat	MALE
ishayu	MALE
ishi	FEMALE
ishika	FEMALE
ishita	FEMALE
ishrat	FEMALE
ishrat	MALE
ishwar	MALE
ishwari	FEMALE
ishwarya	FEMALE
ishya	FEMALE
isin	FEMALE
ismaael	MALE
ismail	MALE
isoruko	MALE
isoshi	MALE
issei	MALE
issouf	MALE
istv&#225	MALE
istvan	MALE
itamar	MALE
itiroo	MALE
itishree	FEMALE
itkila	FEMALE
itsuki	MALE
itsuko	FEMALE
itziar	MALE
iulia	FEMALE
iustin	MALE
ivandr&#233	MALE
ivandr&eacute	MALE
ivandre	MALE
ivo	MALE
ivona	FEMALE
ivy	FEMALE
iwane	MALE
iwao	MALE
iwona	FEMALE
izabela	FEMALE
izanagi	MALE
izanami	FEMALE
izaskun	FEMALE
izdihaar	FEMALE
izhak	MALE
izhar	MALE
izna	FEMALE
izo	MALE
izumi	FEMALE
izumo	MALE
izz	MALE
j?nos	MALE
j?rg	MALE
j?rn	MALE
jaabir	MALE
jaafar	MALE
jaakko	MALE
jaan	MALE
jaap	MALE
jaba	FEMALE
jabeen	FEMALE
jaboah	FEMALE
jachim	MALE
jackson	MALE
jaco	MALE
jacquelijn	FEMALE
jacquet	MALE
jae-ho	MALE
jae-won	MALE
jaeho	MALE
jaeyoung	MALE
jag	MALE
jagadamba	FEMALE
jagadbandu	MALE
jagadeep	MALE
jagadhidh	MALE
jagadish	MALE
jagajeet	MALE
jagajeevan	MALE
jaganmay	MALE
jagannath	MALE
jagat	MALE
jagdeep	MALE
jagdeo	MALE
jagdish	MALE
jagesh	MALE
jagish	MALE
jagjeevan	MALE
jagmohan	MALE
jagrav	MALE
jagravi	FEMALE
jagriti	FEMALE
jagruti	FEMALE
jagvi	FEMALE
jahan	FEMALE
jahan	MALE
jahanara	FEMALE
jahangeer	MALE
jaheel	FEMALE
jahnavi	FEMALE
jahnvi	FEMALE
jai	MALE
jaichand	MALE
jaidayal	MALE
jaideep	MALE
jaidev	MALE
jaigopal	MALE
jaikrishna	MALE
jaiman	MALE
jaime	MALE
jaimini	MALE
jainand	MALE
jainarayan	MALE
jaipal	MALE
jairaj	MALE
jairam	MALE
jaisal	MALE
jaishna	FEMALE
jaishree	FEMALE
jaisudha	FEMALE
jaisukh	MALE
jaival	MALE
jaivant	MALE
jaivardhan	MALE
jaiveer	MALE
jaiwant	MALE
jaiwanti	FEMALE
jakob	MALE
jakub	MALE
jakuchu	MALE
jala	FEMALE
jalaal	MALE
jalabala	FEMALE
jaladhija	FEMALE
jalaj	MALE
jalaja	FEMALE
jalal	MALE
jalendu	MALE
jalesh	MALE
jalil	MALE
jalpesh	MALE
jalsa	FEMALE
jamaal	MALE
jameel	MALE
jameela	FEMALE
jameerah	FEMALE
james	MALE
jamie	MALE
jamini	FEMALE
jaminie	FEMALE
jamir	MALE
jamna	FEMALE
jamuna	FEMALE
jan	MALE
jan	FEMALE
jan-philipp	MALE
jan-thorsten	MALE
jan-torsten	MALE
janaan	FEMALE
janak	MALE
janaki	FEMALE
janamejay	MALE
janani	FEMALE
janara	FEMALE
janardan	MALE
janarththanan	MALE
jane	FEMALE
janesh	MALE
janhavi	FEMALE
janienke	FEMALE
janki	FEMALE
janos	MALE
janu	MALE
januja	FEMALE
janus	MALE
janusz	MALE
janya	FEMALE
janyce	FEMALE
japa	MALE
japendra	MALE
japesh	MALE
japtesh	MALE
jari	MALE
jarka	FEMALE
jarmila	FEMALE
jaroslav	MALE
jarul	FEMALE
jasbeer	MALE
jash	MALE
jashan	MALE
jashmir	MALE
jasmin	FEMALE
jasmit	FEMALE
jasoda	FEMALE
jasodhara	FEMALE
jaspal	MALE
jasraj	MALE
jassi	FEMALE
jasum	FEMALE
jasveer	MALE
jaswant	MALE
jasweer	FEMALE
jatak	MALE
jatan	MALE
jatin	MALE
javed	MALE
javi	MALE
javid	MALE
jawad	MALE
jawahar	MALE
jay	MALE
jaya	FEMALE
jayadeep	MALE
jayadeva	MALE
jayaditya	MALE
jayakumar	MALE
jayalakshmi	FEMALE
jayalalita	FEMALE
jayamala	FEMALE
jayani	FEMALE
jayant	MALE
jayanti	FEMALE
jayantika	FEMALE
jayaprada	FEMALE
jayashekhar	MALE
jayashree	FEMALE
jayashri	FEMALE
jayati	FEMALE
jayavardhini	FEMALE
jayendra	MALE
jayesh	MALE
jayin	MALE
jayita	FEMALE
jaymee	FEMALE
jayprasad	MALE
jaysukh	MALE
je hun	MALE
jean-baptiste	MALE
jean-charles	MALE
jean-claude	MALE
jean-david	MALE
jean-francois	MALE
jean-guy	MALE
jean-leo	MALE
jean-louis	MALE
jean-luc	MALE
jean-marc	MALE
jean-marie	MALE
jean-michel	MALE
jean-philippe	MALE
jean-pierre	MALE
jean-yves	MALE
jeana	FEMALE
jedrzej	MALE
jee-hyub	MALE
jee-sun	FEMALE
jeemutbahan	MALE
jeenal	FEMALE
jeeval	FEMALE
jeevan	MALE
jeevana	FEMALE
jeevankala	FEMALE
jeevanlata	FEMALE
jeevika	FEMALE
jegapriyan	MALE
jegathiswaran	MALE
jehangir	MALE
jehannaz	FEMALE
jelena	FEMALE
jemima	FEMALE
jennifer	FEMALE
jens	MALE
jeong-mi	FEMALE
jeongwon	MALE
jeongwoo	MALE
jeppe	MALE
jereme	MALE
jerid	MALE
jerneja	FEMALE
jeroo	FEMALE
jerry	MALE
jerzy	MALE
jes??s	MALE
jes?s	MALE
jesh	MALE
jeshna	FEMALE
jessie	FEMALE
jetashri	FEMALE
jethran	MALE
jette	FEMALE
jevaria	FEMALE
jewaruben	MALE
jhalak	FEMALE
jhanvi	FEMALE
jharna	FEMALE
jheel	FEMALE
jhilmil	FEMALE
jhinuk	FEMALE
jhoomer	MALE
jhumar	MALE
ji????	MALE
jia-jun	MALE
jiajun	MALE
jianfeng	MALE
jieun	FEMALE
jiganasha	FEMALE
jigar	MALE
jigisha	FEMALE
jigna	FEMALE
jignasa	FEMALE
jignesh	MALE
jigya	FEMALE
jihad	MALE
jihan	MALE
jihie	FEMALE
jihyun	FEMALE
jilpa	FEMALE
jin%ichi	MALE
jin-dong	MALE
jin-seok	MALE
jina	MALE
jinadev	MALE
jinendra	MALE
jing	FEMALE
jing-shin	MALE
jingbo	MALE
jinghui	MALE
jinho	MALE
jinhua	MALE
jinwoo	MALE
jinzaburo	MALE
jiri	MALE
jirka	MALE
jiro	MALE
jirou	MALE
jishnu	MALE
jital	FEMALE
jiten	MALE
jitender	MALE
jitendra	MALE
jitesh	MALE
jitka	FEMALE
jivaj	MALE
jival	MALE
jivantika	FEMALE
jivitesh	MALE
jivraj	MALE
jnhih	MALE
jnyandeep	MALE
jnyaneshwar	MALE
jo	MALE
jo?o	MALE
joachim	MALE
joakim	MALE
joan-andreu	MALE
joanne	FEMALE
joao	MALE
joaquim	MALE
joben	MALE
jochen	MALE
joel	MALE
joeri	MALE
jogesh	MALE
joginder	MALE
jogindra	MALE
jograj	MALE
johan	MALE
johanka	FEMALE
johann	MALE
johanneke	FEMALE
johannes	MALE
johnson	MALE
joji	MALE
joke	FEMALE
jolanta	FEMALE
jomei	MALE
jong wan	MALE
jong-bok	MALE
jong-gyun	MALE
jong-hoon	MALE
jong-hyeok	MALE
jonghoon	MALE
joon-ho	MALE
jordan	MALE
jordi	MALE
jorg	MALE
jorg-uwe	MALE
jorgen	MALE
joris	MALE
jorma	MALE
joruri	FEMALE
jos	MALE
jos&#233	MALE
jos&eacute	MALE
jos?	MALE
jos? mar?a	MALE
jose maria	MALE
joseba	MALE
josee	FEMALE
josep	MALE
joshika	FEMALE
joshita	FEMALE
joshua	MALE
josse	MALE
josuke	MALE
jotaro	MALE
jou	MALE
joungbum	MALE
jowaki	FEMALE
joyce	FEMALE
juan-manuel	MALE
juan-miguel	MALE
judita	FEMALE
judzea	FEMALE
juergen	MALE
jugal	MALE
jugnu	MALE
juhan	MALE
juhi	FEMALE
jui	FEMALE
juichi	MALE
juily	FEMALE
jukka	MALE
julia	FEMALE
juliana	FEMALE
julien	MALE
jumaana	FEMALE
jumpei	MALE
jun	FEMALE
jun	MALE
jun'ichi	MALE
jun-ichi	MALE
jun-sik	MALE
jun-tae	MALE
junaid	MALE
junfu	MALE
jung-goo	MALE
jung-jae	MALE
jung-tae	MALE
jungi	MALE
jungyeul	MALE
jungyun	FEMALE
junhui	MALE
junichi	MALE
junichiro	MALE
junji	MALE
junko	FEMALE
junnosuke	MALE
junpei	MALE
junsik	MALE
juntae	MALE
junwon	MALE
junya	MALE
junzo	MALE
jurgen	MALE
juri	FEMALE
jurij	MALE
juro	MALE
jurobei	MALE
jurou	MALE
jusal	MALE
jussi	MALE
juzaburo	MALE
juzo	MALE
jwalant	MALE
jwalia	MALE
jye-hoon	MALE
jyeshtha	FEMALE
jyothi	FEMALE
jyothishmathi	FEMALE
jyoti	FEMALE
jyotibala	FEMALE
jyotichandra	MALE
jyotika	FEMALE
jyotiprakash	MALE
jyotiranjan	MALE
jyotirdhar	MALE
jyotirmoy	MALE
jyotirmoyee	FEMALE
jyotishmati	FEMALE
jyotsna	FEMALE
jyran	MALE
jyrki	MALE
k.v.	MALE
ka-wai	FEMALE
kaajal	FEMALE
kaamil	MALE
kaamla	FEMALE
kaarel	MALE
kaasni	FEMALE
kaavya	FEMALE
kabir	MALE
kadambari	FEMALE
kadambini	FEMALE
kadeen	FEMALE
kadiri	FEMALE
kado	MALE
kadonomaro	MALE
kadri	MALE
kaede	FEMALE
kaemon	MALE
kafu	MALE
kagami	FEMALE
kagehisa	MALE
kagetoki	MALE
kageyasu	MALE
kahkashan	FEMALE
kahori	FEMALE
kai-fu	MALE
kai-min	MALE
kai-wei	MALE
kai-yun	FEMALE
kaia	FEMALE
kaida	FEMALE
kaii	MALE
kailas	MALE
kailash	MALE
kailashchandra	MALE
kailashnath	MALE
kailyn	FEMALE
kairav	MALE
kaishori	FEMALE
kaito	MALE
kaiya	FEMALE
kaiyo		FEMALE
kaja	FEMALE
kajal	FEMALE
kajjali	FEMALE
kajri	FEMALE
kakali	FEMALE
kakuei	MALE
kakuzo	MALE
kala	FEMALE
kalanidhi	FEMALE
kalap	MALE
kalash	MALE
kalavathi	FEMALE
kalavati	FEMALE
kalesh	MALE
kali	FEMALE
kalicharan	MALE
kalidas	MALE
kalika	FEMALE
kalima	FEMALE
kalimohan	MALE
kalina	FEMALE
kalindi	FEMALE
kalini	FEMALE
kalipada	MALE
kaliranjan	MALE
kallol	FEMALE
kalpana	FEMALE
kalpesh	MALE
kalpita	FEMALE
kalyan	MALE
kalyani	FEMALE
kam-fai	MALE
kamadev	MALE
kamakshee	FEMALE
kamakshi	FEMALE
kamal	FEMALE
kamal	MALE
kamala	FEMALE
kamalaj	MALE
kamalakar	MALE
kamalakshi	FEMALE
kamalapati	MALE
kamalesh	MALE
kamalika	FEMALE
kamalini	FEMALE
kamalkali	FEMALE
kamalnayan	MALE
kamana	FEMALE
kamatari	MALE
kame	FEMALE
kameela	FEMALE
kameko	FEMALE
kamenka	FEMALE
kamesh	MALE
kameyo	FEMALE
kami	FEMALE
kamiko	FEMALE
kamini	FEMALE
kamiwaki	MALE
kamlesh	MALE
kamlyn	FEMALE
kamlyn	MALE
kammi	FEMALE
kammie	FEMALE
kamna	FEMALE
kamod	MALE
kamod;	MALE
kampu	MALE
kamraj;	MALE
kamran	MALE
kamya	FEMALE
kan	MALE
kana	FEMALE
kanaan	MALE
kanad	MALE
kanaiya	MALE
kanak	FEMALE
kanak	MALE
kanaka	FEMALE
kanakabati	FEMALE
kanaklata	FEMALE
kanako	FEMALE
kanakpriya	FEMALE
kanan	FEMALE
kanan	MALE
kananbala	FEMALE
kanav	MALE
kanayo	FEMALE
kanbe	MALE
kanchan	FEMALE
kanchan	MALE
kanchana	FEMALE
kanchi	FEMALE
kandarpa	MALE
kane	MALE
kaneie	MALE
kaneko	FEMALE
kanezane	MALE
kanha	MALE
kanhaiya	MALE
kani	FEMALE
kanika	FEMALE
kanira	FEMALE
kanish	MALE
kanishkan	MALE
kanj	MALE
kanjiro	MALE
kanjri	FEMALE
kankana	FEMALE
kanko	MALE
kannon	MALE
kano	MALE
kanon	FEMALE
kansuke	MALE
kant	MALE
kanta	FEMALE
kantaro	MALE
kanthi	FEMALE
kanti	FEMALE
kantilal	MALE
kantimoy	MALE
kanu	MALE
kanuja	FEMALE
kanupriya	FEMALE
kanvar	MALE
kanwal	MALE
kanwaljeet	MALE
kanwaljit	MALE
kanwalkishore	MALE
kanzaburo	MALE
kaori	FEMALE
kaori	MALE
kaoru	FEMALE
kaoru	MALE
kaorukasuga	FEMALE
kapil	MALE
kapila	FEMALE
kapish	MALE
kapoor	MALE
kapotakshi	FEMALE
karabi	FEMALE
karan	MALE
kareem	MALE
kareema	FEMALE
kareena	FEMALE
karel	MALE
kari	FEMALE
karim	MALE
karishma	FEMALE
karl-heinz	MALE
karl-michael	MALE
karlheinz	MALE
karm	MALE
karmendra	MALE
karmjit	MALE
karna	MALE
karnam	MALE
karolina	FEMALE
karoly	MALE
karona	FEMALE
karsten	MALE
kartar	MALE
karthik	MALE
kartik	MALE
kartikeya	MALE
karuli	FEMALE
karuna	FEMALE
karunakar	MALE
karunamay	MALE
karunamayi	FEMALE
karunashankar	MALE
karunesh	MALE
karunya	FEMALE
kashi	FEMALE
kashi	MALE
kashif	MALE
kashika	FEMALE
kashin	FEMALE
kashinath	MALE
kashiprasad	MALE
kashish	FEMALE
kashmira	FEMALE
kashvi	FEMALE
kashyap	MALE
kashyapi	FEMALE
kasish	MALE
kassamali	MALE
kasturi	FEMALE
kasumi	FEMALE
kata	FEMALE
kata	MALE
katai	MALE
katarzyna	FEMALE
katashi	MALE
katerina	FEMALE
kathir	MALE
kathir;	MALE
kathrin	FEMALE
katja	FEMALE
katri	FEMALE
katrin	FEMALE
katrina	FEMALE
katsu	MALE
katsue	FEMALE
katsuhiko	MALE
katsuhito	MALE
katsuko	FEMALE
katsumi	FEMALE
katsumi	MALE
katsumori	MALE
katsumoto	MALE
katsunan	MALE
katsunori	MALE
katsunosuki	MALE
katsuo	MALE
katsuro	MALE
katsuteru	MALE
katsuya	MALE
katsuyoshi	MALE
katsuyuki	MALE
katunobu	MALE
katya	FEMALE
katyayani	FEMALE
katzumi	MALE
kaumudi	FEMALE
kausar	MALE
kauser	FEMALE
kaushal	MALE
kaushalya	FEMALE
kaushey	FEMALE
kaushik	MALE
kaustav	MALE
kaustubh	MALE
kautik	MALE
kavan	MALE
kavel	MALE
kaveri	FEMALE
kavi	MALE
kavika	FEMALE
kavin	FEMALE
kavin	MALE
kaviraj	MALE
kavish	MALE
kavita	FEMALE
kawai	FEMALE
kawanari	MALE
kawkab	FEMALE
kawthar	FEMALE
kaya	FEMALE
kayo	FEMALE
kayoko	FEMALE
kayomi	FEMALE
kayosh	MALE
kaz	MALE
kazu	MALE
kazuaki	MALE
kazue	FEMALE
kazuhide	MALE
kazuhiko	MALE
kazuhiro	MALE
kazuhisa	MALE
kazuki	MALE
kazuko	FEMALE
kazuko	MALE
kazuma	MALE
kazumasa	MALE
kazumi	FEMALE
kazunari	MALE
kazunori	MALE
kazuo	MALE
kazushi	MALE
kazushige	MALE
kazuteru	MALE
kazutoshi	MALE
kazuya	MALE
kazuyoshi	MALE
kazuyuki	MALE
keanu	MALE
kecia	FEMALE
kedar	MALE
kedarnath	MALE
keeritika	FEMALE
keertana	FEMALE
keerthana	FEMALE
kees	MALE
keh-jiann	MALE
keh-yih	MALE
kehani	FEMALE
kei	FEMALE
kei	MALE
keiichi	MALE
keiichiro	MALE
keiji	MALE
keiki	MALE
keiko	FEMALE
keishi	MALE
keisuke	MALE
keita	MALE
keitaro	MALE
keiyona	FEMALE
keizo	MALE
kemal	MALE
ken	MALE
ken'ichi	MALE
kengo	MALE
kenichi	MALE
kenji	MALE
kenjiro	MALE
kenkichi	MALE
kenko	MALE
kenmaur	MALE
kensaku	MALE
kenshin	MALE
kenta	MALE
kentaro	MALE
kenum	FEMALE
kenzaburo	MALE
kenzan	MALE
kenzo	MALE
kepa	MALE
kerry	FEMALE
kerstin	FEMALE
kesar	FEMALE
kesar	MALE
kesari	FEMALE
keshav	MALE
keshi	FEMALE
keshika	FEMALE
keshini	FEMALE
keshto	MALE
ketak	MALE
ketaki	FEMALE
ketan	MALE
ketana	FEMALE
ketav	MALE
ketki	FEMALE
ketu	MALE
ketubh	MALE
keva	FEMALE
kevalkishore	MALE
kevalkumar	MALE
kevin	MALE
kevyn	FEMALE
kewal	MALE
key-sun	MALE
keya	FEMALE
keyur	MALE
keyuri	FEMALE
khadeeja	FEMALE
khadim	MALE
khair	MALE
khairiya	FEMALE
khairy	MALE
khajit	MALE
khaldoon	MALE
khaled	MALE
khaleel	MALE
khalid	MALE
khalida	FEMALE
khalil	MALE
khanjan	MALE
khawlah	FEMALE
khazana	MALE
khemchand	MALE
khemprakash	MALE
khili	FEMALE
kholisa	FEMALE
khulood	FEMALE
khundmir	MALE
khurshid	MALE
khushal	MALE
khushboo	FEMALE
khushi	FEMALE
khusi	FEMALE
khuzaymah	MALE
khyati	FEMALE
ki-joong	MALE
kiara	FEMALE
kichi	FEMALE
kichibei	MALE
kichiro	MALE
kichirou	MALE
kichisaburo	MALE
kie	FEMALE
kiefer	FEMALE
kiemon	MALE
kieran	MALE
kiichi	MALE
kijuro	MALE
kikaku	MALE
kiko	FEMALE
kiku	FEMALE
kikugoro	MALE
kikunojo	MALE
kikuo	MALE
kilian	MALE
killan	MALE
kilyoun	MALE
kim-fai	MALE
kimaya	FEMALE
kimi	FEMALE
kimi	MALE
kimie	FEMALE
kimikazu	MALE
kimiko	FEMALE
kiminobu	MALE
kimitada	MALE
kimmo	MALE
kin	FEMALE
kin	MALE
kinaari	FEMALE
kingo	MALE
kinjal	FEMALE
kinji	MALE
kinmochi	MALE
kinnar	MALE
kinnari	FEMALE
kinnojo	MALE
kinnosuke	MALE
kino	MALE
kinshuk	MALE
kintuben	FEMALE
kinuko	FEMALE
kinuye	FEMALE
kinuyo	FEMALE
kinzo	MALE
kioko	FEMALE
kioshi	MALE
kiran	FEMALE
kiran	MALE
kiranmala	FEMALE
kiranmay	MALE
kirat	MALE
kirati	FEMALE
kiratidev	MALE
kirby	MALE
kireeti	MALE
kiril	MALE
kirill	MALE
kirin	MALE
kirit	MALE
kirtan	MALE
kirtana	FEMALE
kirti	FEMALE
kirti	MALE
kirtikumar	MALE
kirtin	MALE
kishan	MALE
kishi	FEMALE
kisho	MALE
kishor	MALE
kishore	MALE
kishorekumar	MALE
kishori	FEMALE
kit	FEMALE
kita	FEMALE
kitahachi	MALE
kiwako	FEMALE
kiyo	FEMALE
kiyoaki	MALE
kiyoemon	MALE
kiyohira	MALE
kiyohiro	MALE
kiyohisa	MALE
kiyoko	FEMALE
kiyomasu	MALE
kiyomi	FEMALE
kiyomori	MALE
kiyonaga	MALE
kiyonobu	MALE
kiyonori	MALE
kiyoshi	MALE
kiyotaka	MALE
kjell	MALE
klaas	MALE
klara	FEMALE
klaus	MALE
klaus-jurgen	MALE
klaus-peter	MALE
klemens	MALE
klinton	MALE
knut	MALE
koan	MALE
kobo	MALE
kobus	MALE
koby	MALE
kochiyo	FEMALE
koen	MALE
koenraad	MALE
koetsu	MALE
kohana	FEMALE
kohei	MALE
kohji	MALE
koi	FEMALE
koichi	MALE
koichiro	MALE
koin	MALE
koiso	FEMALE
koiti	MALE
koji	MALE
kojiro	MALE
kojuro	MALE
kokan	MALE
kokei	MALE
koken	FEMALE
koki	MALE
kokichi	MALE
kokila	FEMALE
koko	FEMALE
kokoro	FEMALE
kokushi	MALE
komachi	FEMALE
komal	FEMALE
komala	FEMALE
komali	FEMALE
kong joo	FEMALE
konika	FEMALE
konosuke	MALE
konoye	MALE
konrad	MALE
konstantin	MALE
konstantinos	MALE
konyo	MALE
kopal	FEMALE
kopal	MALE
korechika	MALE
korekiyo	MALE
korenaga	MALE
korenia	FEMALE
korin	MALE
kornel	MALE
koryusai	MALE
kosaku	MALE
kosami	MALE
kosha	FEMALE
koshin	MALE
koshiro	MALE
kosho	MALE
kostadin	MALE
kostas	MALE
kotaro	MALE
koto	FEMALE
koto	MALE
kotone	FEMALE
kouichi	MALE
kouji	MALE
kouki	MALE
kouta	MALE
kouther	FEMALE
kovidh	MALE
kow	MALE
koyal	FEMALE
koyel	FEMALE
koyo	MALE
kozo	MALE
kozue	MALE
kozuke	MALE
krandasi	FEMALE
kranti	FEMALE
krasimir	MALE
kreena	FEMALE
kripa	FEMALE
kripal	MALE
kripi	FEMALE
krish	MALE
krisha	FEMALE
krishang	MALE
krishanu	MALE
krishay	MALE
krishi	MALE
krishna	FEMALE
krishna	MALE
krishnaa	FEMALE
krishnachandra	MALE
krishnadeva	MALE
krishnakali	FEMALE
krishnakanta	MALE
krishnakumar	MALE
krishnala	MALE
krishnamurari	MALE
krishnamurthy	MALE
krishnaroop	MALE
krishnendu	MALE
krister	MALE
kristiina	FEMALE
kristof	MALE
kristy	FEMALE
krisztian	MALE
kritanu	MALE
krithinidhi	MALE
kriti	FEMALE
kritika	MALE
kritiman	MALE
krittika	FEMALE
krivi	MALE
krupa	FEMALE
krupali	FEMALE
kruthika	FEMALE
kruti	FEMALE
krzysztof	MALE
kshama	FEMALE
kshamya	FEMALE
kshanika	FEMALE
kshantu	MALE
kshaunish	MALE
kshipraa	FEMALE
kshipva	FEMALE
kshiraj	MALE
kshiraja	FEMALE
kshirin	FEMALE
kshitij	MALE
kshrugal	MALE
kuber	MALE
kuberchand	MALE
kuemon	MALE
kugatsu	MALE
kuhu	FEMALE
kuja	FEMALE
kularanjan	MALE
kulbhushan	MALE
kuldeep	MALE
kuljesh	MALE
kulthoom	FEMALE
kuma	MALE
kumanosuke	MALE
kumar	MALE
kumaran	MALE
kumaresh	MALE
kumari	FEMALE
kumi	FEMALE
kumiko	FEMALE
kumkum	FEMALE
kumud	FEMALE
kumudesh	MALE
kumudini	FEMALE
kunal	MALE
kunda	FEMALE
kunda	MALE
kundan	FEMALE
kundan	MALE
kundanika	FEMALE
kundanlal	MALE
kuni	FEMALE
kuniaki	MALE
kunie	FEMALE
kunihiko	MALE
kuniko	FEMALE
kunimatsu	MALE
kunimichi	MALE
kunio	MALE
kunisada	MALE
kunitaro	MALE
kuniyoshi	MALE
kuniyuki	MALE
kunja	MALE
kunjabihari	MALE
kunjal	FEMALE
kunjalata	FEMALE
kunjana	FEMALE
kunsh	MALE
kunshi	FEMALE
kuntal	FEMALE
kuntal	MALE
kuntala	FEMALE
kunti	FEMALE
kunwar	MALE
kura	FEMALE
kurangi	FEMALE
kuresh	MALE
kuri	FEMALE
kuri	MALE
kuro	MALE
kurou	MALE
kush	MALE
kushal	MALE
kushala	FEMALE
kushanu	MALE
kushik	MALE
kusum	FEMALE
kusuma	FEMALE
kusumakar	MALE
kusumanjali	FEMALE
kusumavati	FEMALE
kusumesh	MALE
kusumita	FEMALE
kusumlata	FEMALE
kuval	MALE
kuvam	FEMALE
kuvam	MALE
kuvar	MALE
kuvira	FEMALE
kuzman	MALE
kvanh	MALE
kwangseob	MALE
kyoden	MALE
kyoichi	MALE
kyoji	MALE
kyoko	FEMALE
kyonghi	FEMALE
kyongho	MALE
kyoshi	MALE
kyoung-young	MALE
kyu-baek	MALE
kyuichi	MALE
kyung-mi	FEMALE
kyung-soon	FEMALE
kyungsun	FEMALE
kyushichi	MALE
kyuso	MALE
kyuwa	MALE
kyuwoong	MALE
l?szl?	MALE
laabha	FEMALE
laalamani	FEMALE
laasya	FEMALE
labangalata	FEMALE
labeeb	MALE
labh	MALE
laboni	FEMALE
labuki	FEMALE
ladli	FEMALE
lagan	FEMALE
lagan	MALE
laghuvi	FEMALE
lahar	MALE
lahari	FEMALE
lahsen	MALE
laiba	FEMALE
lajita	FEMALE
lajja	FEMALE
lajjawati	FEMALE
lajwanti	FEMALE
lajwati	FEMALE
lakhan	MALE
lakhi	FEMALE
laksha	FEMALE
lakshaki	FEMALE
lakshan	MALE
lakshana	FEMALE
lakshanya	FEMALE
lakshay	MALE
lakshita	FEMALE
lakshman	MALE
lakshmi	FEMALE
lakshmibanta	MALE
lakshmidhar	MALE
lakshmigopal	MALE
lakshmikanta	MALE
lakshmishree	FEMALE
lakshya	FEMALE
lalam	MALE
lalan	FEMALE
lalana	FEMALE
lali	FEMALE
lali	MALE
lalima	FEMALE
lalit	MALE
lalita	FEMALE
lalitaditya	MALE
lalitamohana	FEMALE
lalitchandra	MALE
lalitha	FEMALE
lalitkishore	MALE
lalitkumar	MALE
lalitmohan	MALE
lama	FEMALE
lambodar	MALE
lambodhar	MALE
lambros	MALE
lamees	FEMALE
lamya	FEMALE
lani	FEMALE
laniban	MALE
lankesh	MALE
laranya	FEMALE
larina	FEMALE
larraj	MALE
lars	MALE
laszlo	MALE
lata	FEMALE
latafat	MALE
latakara	FEMALE
latangi	FEMALE
latasha	FEMALE
lateefa	FEMALE
latha	FEMALE
latif	MALE
latika	FEMALE
laura	FEMALE
laurent	MALE
laurianne	FEMALE
lav	MALE
lavali	FEMALE
lavanya	FEMALE
laveena	FEMALE
laven	MALE
lavena	FEMALE
lavitra	MALE
laxman	MALE
laxmi	FEMALE
layak	MALE
leandra	FEMALE
lee-feng	MALE
leela	FEMALE
leelamayee	FEMALE
leelavati	FEMALE
leem seop	MALE
leena	FEMALE
leif-joran	MALE
leiko	FEMALE
leila	FEMALE
lekh	MALE
lekha	FEMALE
lemar	MALE
lemmie	FEMALE
lenhart	MALE
leonaxdo	MALE
leonid	MALE
leszek	MALE
lev	MALE
li-li	FEMALE
lianhong	FEMALE
libin	MALE
libni	FEMALE
lidija	FEMALE
lidiya	FEMALE
liesbeth	FEMALE
liesl	FEMALE
ligy	FEMALE
likhitha	FEMALE
likith	MALE
liladhar	MALE
lilawatti	FEMALE
lili	FEMALE
lilja	FEMALE
lily	FEMALE
limna	FEMALE
lincy	FEMALE
linisha	FEMALE
linus	MALE
lipi	FEMALE
lipika	FEMALE
lira	FEMALE
liviu	MALE
llu&#237	MALE
llu??s	MALE
llu?s	MALE
lluis	MALE
lochan	FEMALE
lochan	MALE
lochana	FEMALE
lohendra	MALE
lohitaksh	MALE
lohitaksha	MALE
lokendra	MALE
lokesh	MALE
loknath	MALE
lokprakash	MALE
lokranjan	MALE
lola	FEMALE
lolita	FEMALE
lomash	MALE
lona	FEMALE
longbin	MALE
lonneke	FEMALE
lopa	FEMALE
lopamudra	FEMALE
lorne	MALE
loshini	FEMALE
lotfi	MALE
lothar	MALE
louis	MALE
louis-philippe	MALE
louisette	FEMALE
love	FEMALE
loveleen	FEMALE
lu'ay	MALE
lu?s	MALE
lubaaba	FEMALE
lubos	MALE
luc	MALE
luca	MALE
lucas	MALE
lucian	MALE
lucja	FEMALE
ludmila	FEMALE
ludovic	MALE
luiz	MALE
luka	MALE
lukas	MALE
lulu	FEMALE
luminita	FEMALE
luqmaan	MALE
lutfi	MALE
luv	MALE
lysiane	FEMALE
lyudmila	FEMALE
m?rk	MALE
ma'awiya	MALE
ma'd	MALE
ma'n	MALE
maahir	MALE
maalav	MALE
maalin	MALE
maalolan	MALE
maanasa	FEMALE
maanika	FEMALE
maarika	FEMALE
maarten	MALE
maayan	FEMALE
maazin	MALE
mabuchi	MALE
machi	FEMALE
machiko	FEMALE
madan	MALE
madangopal	MALE
madanika	FEMALE
madeeha	FEMALE
madelaine	FEMALE
madesh	MALE
madhav	MALE
madhavan	MALE
madhavdas	MALE
madhavi	FEMALE
madhavilata	FEMALE
madhu	FEMALE
madhu	MALE
madhubala	FEMALE
madhuban	MALE
madhuchanda	FEMALE
madhuk	MALE
madhukanta	MALE
madhukar	MALE
madhuksara	FEMALE
madhul	FEMALE
madhulata	FEMALE
madhulekha	FEMALE
madhulika	FEMALE
madhumalati	FEMALE
madhumathi	FEMALE
madhumati	FEMALE
madhumitha	FEMALE
madhunisha	FEMALE
madhup	MALE
madhur	FEMALE
madhur	MALE
madhura	FEMALE
madhuram	MALE
madhuri	FEMALE
madhurima	FEMALE
madhusha	FEMALE
madhushri	FEMALE
madhusudan	MALE
madhusudhana	MALE
madhuvanthi	FEMALE
madin	MALE
madirakshi	FEMALE
madoka	FEMALE
mae	FEMALE
maeko	FEMALE
mael	MALE
maemi	FEMALE
magadhi	FEMALE
magan	MALE
magana	FEMALE
magbei	MALE
maghi	FEMALE
magnus	MALE
magobei	MALE
magohachi	MALE
maha	FEMALE
mahabahu	MALE
mahabala	MALE
mahadev	MALE
mahadevi	FEMALE
mahagauri	FEMALE
mahajabeen	FEMALE
mahaketu	MALE
mahakram	MALE
mahalakshmi	FEMALE
mahamani	MALE
mahamaya	FEMALE
mahaniya	MALE
mahant	MALE
maharshi	MALE
mahasri	FEMALE
mahasweta	FEMALE
mahati	FEMALE
mahatru	MALE
mahavir	MALE
mahboob	MALE
mahdy	MALE
mahee	FEMALE
maheepati	MALE
mahek	FEMALE
mahendi	FEMALE
mahendra	MALE
mahesh	MALE
maheshwar	MALE
mahi	FEMALE
mahijuba	FEMALE
mahika	FEMALE
mahima	FEMALE
mahin	MALE
mahindra	MALE
mahipal	MALE
mahiraj	MALE
mahish	MALE
mahit	MALE
mahita	FEMALE
mahiya	FEMALE
mahmoud	MALE
mahmud	MALE
mahrishi	MALE
mahtab	FEMALE
mahtab	MALE
mahua	FEMALE
mahuya	FEMALE
mai	FEMALE
maik	MALE
maiko	FEMALE
maimoona	FEMALE
maina	FEMALE
mainak	MALE
maisa	FEMALE
maite	FEMALE
maithili	FEMALE
maitreya	FEMALE
maitreya	MALE
maitreyi	FEMALE
maitri	FEMALE
maiya	FEMALE
maja	FEMALE
majd	MALE
majdy	MALE
majeeda	FEMALE
majida	FEMALE
makaarim	FEMALE
makarand	MALE
makeen	MALE
makhesh	MALE
maki	FEMALE
makiko	FEMALE
mako	FEMALE
makoto	MALE
makrand	MALE
makshi	FEMALE
makul	MALE
mala	FEMALE
malak	FEMALE
malan	MALE
malank	MALE
malarvizhi	FEMALE
malashree	FEMALE
malati	FEMALE
malav	MALE
malavika	FEMALE
malay	MALE
malaya	FEMALE
maleah	FEMALE
maleeha	FEMALE
malik	MALE
malika	FEMALE
malin	FEMALE
malina	FEMALE
malini	FEMALE
maljumana	FEMALE
malka	FEMALE
mallesh	MALE
malli	FEMALE
mallika	FEMALE
malte	FEMALE
malti	FEMALE
malvina	FEMALE
mamata	FEMALE
mamdouh	MALE
mami	FEMALE
mamiko	FEMALE
mamnoon	MALE
mamoru	MALE
mamraj	MALE
mamta	FEMALE
man	FEMALE
mana	FEMALE
manaal	FEMALE
manaar	FEMALE
manabu	MALE
manali	FEMALE
manami	FEMALE
manan	MALE
manana	FEMALE
manas	MALE
manasa	FEMALE
manasi	FEMALE
manasi	MALE
manav	MALE
manavendra	MALE
manda	FEMALE
mandakini	FEMALE
mandakranta	FEMALE
mandar	MALE
mandaraa	FEMALE
mandarmalika	FEMALE
mandavi	FEMALE
mandeep	MALE
mandhatri	MALE
mandira	FEMALE
manendra	MALE
manesh	MALE
manfred	MALE
mangal	MALE
mangala	FEMALE
mangesh	MALE
mangla	FEMALE
manhar	MALE
manhung	MALE
mani	FEMALE
mani	MALE
manibhushan	MALE
manideepa	FEMALE
manik	FEMALE
manik	MALE
manika	FEMALE
manikuntala	FEMALE
manimala	FEMALE
manimekhala	FEMALE
manindra	MALE
manini	FEMALE
maniram	MALE
maniratna	FEMALE
manish	MALE
manisha	FEMALE
manishankar	MALE
manit	MALE
manja	FEMALE
manjari	FEMALE
manjeet	MALE
manjira	FEMALE
manjistha	FEMALE
manju	FEMALE
manjubala	FEMALE
manjula	FEMALE
manjulika	FEMALE
manjusha	FEMALE
manjushri	FEMALE
manjusri	FEMALE
manjyot	FEMALE
manmatha	MALE
manmayi	FEMALE
manmohan	MALE
manna	FEMALE
mannan	MALE
manny	MALE
manobu	MALE
manohar	MALE
manoj	MALE
manorama	FEMALE
manoranjan	MALE
manoranjana	FEMALE
manprasad	MALE
mansha	FEMALE
mansi	FEMALE
mansour	MALE
mansukh	MALE
mantaro	MALE
mantha	MALE
manu	MALE
manushri	FEMALE
manvi	FEMALE
manzo	MALE
mao	FEMALE
maosong	MALE
mar?a teresa	FEMALE
mar?a-consuelo	FEMALE
maraam	FEMALE
marala	FEMALE
marcello	MALE
marcilio	MALE
marcin	MALE
mardav	MALE
mare	FEMALE
mareechi	MALE
marek	MALE
marelie	FEMALE
mareo	MALE
maresuke	MALE
margalit	FEMALE
margarita	FEMALE
margarita	MALE
margherita	FEMALE
margi	FEMALE
mari	FEMALE
mari-sanna	FEMALE
marichi	FEMALE
marie-catherine	FEMALE
marie-claude	FEMALE
marie-francine	FEMALE
marie-gaelle	FEMALE
marie-helene	FEMALE
marie-jean	FEMALE
marie-jeanne	FEMALE
marie-josee	FEMALE
marie-paule	FEMALE
marieke	FEMALE
marielle	FEMALE
mariet	FEMALE
marihito	MALE
marijn	MALE
mariko	FEMALE
marilisa	FEMALE
marina	FEMALE
marine	FEMALE
mariona	FEMALE
maris	MALE
marisa	FEMALE
marise	FEMALE
marise	MALE
maritxell	FEMALE
marius	MALE
marjolein	FEMALE
mark-christoph	MALE
mark-jan	MALE
markanday	MALE
markandeya	FEMALE
markandeya	MALE
marketa	FEMALE
marko	MALE
markos	MALE
maro	MALE
marsden	MALE
marsha	FEMALE
mart&#237	FEMALE
martand	MALE
martanda	MALE
martial	MALE
martijn	MALE
maru	FEMALE
marut	MALE
maruti	MALE
marwan	MALE
maryam	FEMALE
maryse	FEMALE
maryvonne	FEMALE
marzouq	MALE
masaaki	MALE
masae	FEMALE
masafumi	MALE
masaharu	MALE
masahide	MALE
masahiko	MALE
masahiro	MALE
masahito	MALE
masakado	MALE
masakatsu	MALE
masakazu	MALE
masaki	MALE
masakiyo	MALE
masako	FEMALE
masami	FEMALE
masami	MALE
masamichi	MALE
masamitsu	MALE
masamune	MALE
masanobu	MALE
masanori	MALE
masao	MALE
masaru	MALE
masashi	MALE
masashige	MALE
masatake	MALE
masato	MALE
masatoshi	MALE
masatsugu	MALE
masaya	MALE
masayo	FEMALE
masayoshi	MALE
masayuki	MALE
masazumi	MALE
mashai	MALE
mashashi	MALE
mashiro	MALE
masood	MALE
masoud	MALE
massimiliano	MALE
massimo	MALE
mastikh	MALE
masu	MALE
masuhiro	MALE
masujiro	MALE
masumi	FEMALE
masuru	MALE
masutaro	MALE
masuyo	FEMALE
masuzo	MALE
matabei	MALE
matangi	FEMALE
matashichi	MALE
mateah	FEMALE
matej	MALE
mathias	MALE
mathieu	MALE
mathis	MALE
matisha	FEMALE
mats	MALE
matsendra	MALE
matsu	FEMALE
matsu	MALE
matsudaira	MALE
matsuko	FEMALE
matsuo	MALE
matsusuke	MALE
matsuta	MALE
matsuyo	MALE
matteo	MALE
matthias	MALE
matthieu	MALE
matti	MALE
mattias	MALE
maulashree	FEMALE
maulik	MALE
maurizio	MALE
mausam	FEMALE
mausami	FEMALE
mausumi	FEMALE
mawiya	FEMALE
maxim	MALE
maximilian	MALE
maximiliano	MALE
maxkus	MALE
may	FEMALE
maya	FEMALE
mayako	FEMALE
mayank	MALE
mayanka	MALE
mayo	FEMALE
mayoko	FEMALE
maysaa	FEMALE
maysarah	MALE
maysoon	FEMALE
mayu	FEMALE
mayuka	FEMALE
mayukh	MALE
mayukhi	FEMALE
mayuko	FEMALE
mayumi	FEMALE
mayur	MALE
mayura	FEMALE
mayurakhsi	FEMALE
mayuri	FEMALE
mayurika	FEMALE
mayyada	FEMALE
medha	FEMALE
medhaj	MALE
medini	FEMALE
meena	FEMALE
meenakshi	FEMALE
meenal	FEMALE
meer	MALE
meera	FEMALE
meera	MALE
meeraja	FEMALE
meet	MALE
megh	MALE
megha	FEMALE
megha	MALE
meghaj	MALE
meghal	FEMALE
meghamala	FEMALE
meghana	FEMALE
meghashyam	MALE
meghdutt	MALE
meghna	FEMALE
meghnad	MALE
megu	FEMALE
megumi	FEMALE
meha	FEMALE
mehak	FEMALE
mehal	FEMALE
mehal	MALE
mehanaz	FEMALE
mehboob	MALE
mehbooba	FEMALE
mehdi	MALE
meher	FEMALE
mehmet	MALE
mehmood	MALE
mehreen	FEMALE
mehrunissa	FEMALE
mehryar	MALE
mehul	FEMALE
mehul	MALE
mei	FEMALE
meiji	MALE
meilan	FEMALE
mekhala	FEMALE
melanie	FEMALE
melita	FEMALE
melvyn	MALE
mena	FEMALE
menaha	FEMALE
menaja	FEMALE
menaka	FEMALE
mengqiu	MALE
meni	MALE
menka	FEMALE
menno	MALE
mi	FEMALE
mi-young	FEMALE
micha	MALE
michela	FEMALE
michelangelo	MALE
michele	MALE
michelina	FEMALE
michelle	FEMALE
michi	FEMALE
michie	FEMALE
michiel	MALE
michihiro	MALE
michiko	FEMALE
michinaga	MALE
michinori	MALE
michio	MALE
michitaka	MALE
michizane	MALE
mick	MALE
midori	FEMALE
mieko	FEMALE
miguel	MALE
mihaela	FEMALE
mihai	MALE
mihika	FEMALE
mihir	MALE
miho	FEMALE
mihoko	FEMALE
miiko	FEMALE
mijail	MALE
mika	FEMALE
mikael	MALE
mikaela	FEMALE
mikhael	MALE
mikhail	MALE
miki	FEMALE
miki	MALE
mikiko	FEMALE
mikio	MALE
mikito	MALE
mikko	MALE
mikku	FEMALE
miklos	MALE
miku	FEMALE
mikul	MALE
mikyung	FEMALE
milan	MALE
miland	MALE
milap	MALE
milen	FEMALE
milena	FEMALE
mili	FEMALE
milica	FEMALE
miliko	FEMALE
milind	MALE
milit	MALE
miloni	FEMALE
milos	MALE
milun	MALE
min-jeong	FEMALE
min-yen	MALE
mina	FEMALE
minako	FEMALE
minakshi	FEMALE
minal	FEMALE
minati	FEMALE
mineki	MALE
mineko	FEMALE
ming-wei	MALE
minghui	MALE
mini	FEMALE
mino	FEMALE
minoru	MALE
minsuk	MALE
minu	FEMALE
minwoo	MALE
mio	FEMALE
mipasha	FEMALE
mira	FEMALE
miray	FEMALE
miraya	FEMALE
mirella	FEMALE
mirium	FEMALE
miroslav	MALE
mirza	MALE
misa	FEMALE
misaki	FEMALE
misako	FEMALE
misal	MALE
misao	MALE
misato	FEMALE
misbaah	MALE
misha	FEMALE
mishka	FEMALE
mishti	FEMALE
misook	FEMALE
misri	FEMALE
mita	FEMALE
mitali	FEMALE
miten	MALE
mitesh	MALE
mithil	MALE
mithilesh	MALE
mithun	MALE
mito	MALE
mitra	FEMALE
mitra	MALE
mitrajit	MALE
mitsuharu	MALE
mitsuhide	MALE
mitsuhiro	MALE
mitsuko	FEMALE
mitsukuni	MALE
mitsunari	MALE
mitsunobu	MALE
mitsunori	MALE
mitsuo	MALE
mitsuoki	MALE
mitsuru	MALE
mitsutaka	MALE
mitsuyo	FEMALE
mitsuzuka	MALE
mittu	FEMALE
mitul	MALE
mitwa	MALE
miu	FEMALE
miwa	FEMALE
miwako	FEMALE
miya	FEMALE
miyako	FEMALE
miyazaki	MALE
miyo	FEMALE
miyoko	FEMALE
miyoko	MALE
miyoshi	FEMALE
miyu	FEMALE
miyuki	FEMALE
mizuki	FEMALE
mladen	MALE
mobumasu	MALE
mochihito	MALE
modak	MALE
modal	MALE
moe	FEMALE
moh	MALE
mohajit	MALE
mohak	MALE
mohal	MALE
mohamad	MALE
mohan	MALE
mohana	FEMALE
mohd	MALE
mohin	MALE
mohini	FEMALE
mohisha	FEMALE
mohit	MALE
mohita	MALE
mohnish	MALE
mohsen	MALE
mohul	MALE
moin	MALE
mokichi	MALE
moksh	MALE
mokuami	MALE
momo	FEMALE
momoe	FEMALE
momoka	FEMALE
momoko	FEMALE
momoru	MALE
mona	FEMALE
monal	FEMALE
monalisa	FEMALE
moneshaa	FEMALE
monica	FEMALE
monish	MALE
monisha	FEMALE
monojit	MALE
montaro	MALE
montesh	MALE
monthika	FEMALE
montse	FEMALE
montserrat	FEMALE
monzaemon	MALE
moonjoo	FEMALE
moosa	MALE
morena	FEMALE
morie	MALE
morihiro	MALE
moriko	FEMALE
morimasa	MALE
morio	MALE
moritz	MALE
moromao	MALE
moronobu	MALE
mort	MALE
mostafa	MALE
moti	MALE
motilal	MALE
motoichi	MALE
motoki	MALE
motonobu	MALE
motoshige	MALE
mototsune	MALE
motoyasu	MALE
motoyuki	MALE
moubani	FEMALE
moulik	MALE
mounia	FEMALE
mounica	FEMALE
movind	MALE
mridhula	FEMALE
mridini	FEMALE
mridu	FEMALE
mridul	MALE
mridula	FEMALE
mrigaj	MALE
mriganayani	FEMALE
mriganka	MALE
mrigankamouli	MALE
mrigankasekhar	MALE
mrigasya	MALE
mrigendra	MALE
mrigesh	MALE
mrinal	FEMALE
mrinal	MALE
mrinali	FEMALE
mrinalini	FEMALE
mrinmayee	FEMALE
mrinmayi	FEMALE
mritheya	MALE
mritsa	FEMALE
mrittika	FEMALE
mritunjay	MALE
mrityunjay	MALE
mrudula	FEMALE
mrug	MALE
mrunali	FEMALE
mstislav	MALE
mu	MALE
muaath	MALE
muayid	MALE
mubarak	FEMALE
mubarak	MALE
mudil	MALE
mudit	MALE
mudita	MALE
mudra	FEMALE
mudrika	FEMALE
mufeed	MALE
mufeeda	FEMALE
mugdha	FEMALE
muhamad	MALE
muhammad	MALE
muhannad	MALE
muhja	FEMALE
muhsin	MALE
muhtady	MALE
mujaahid	MALE
mujibur	MALE
mukesh	MALE
mukhtaar	MALE
mukta	FEMALE
muktananda	MALE
mukti	FEMALE
mukul	MALE
mukula	FEMALE
mukulita	FEMALE
mukund	MALE
mukunda	MALE
mukut	MALE
mulkraj	MALE
mullinti	MALE
mumtaz	MALE
muna	FEMALE
munawwar	MALE
muneer	MALE
muneera	FEMALE
munemitsu	MALE
munemori	MALE
munenori	MALE
muneyaki	MALE
muni	MALE
munish	MALE
muniya	FEMALE
munjal	MALE
munoto	MALE
muntasir	MALE
munthir	MALE
mura	FEMALE
murad	MALE
murai	MALE
murali	MALE
muralidhar	MALE
muralimanohar	MALE
murari	MALE
murarilal	MALE
murat	MALE
murli	MALE
murtadhy	MALE
musa	MALE
musad	MALE
mushanokoji	MALE
musheer	MALE
musheera	FEMALE
muskaan	FEMALE
muslim	MALE
mustafa	MALE
musu	FEMALE
mutaa	MALE
mutasim	MALE
mutazz	MALE
mutee	MALE
muthu	FEMALE
muthu	MALE
mutsohito	MALE
mutsuko	FEMALE
mutsumi	FEMALE
muwafaq	MALE
mya	FEMALE
myroslava	FEMALE
mythili	FEMALE
mythilli	FEMALE
mythily	FEMALE
mythri	FEMALE
myung-gil	MALE
myunghee	FEMALE
naa'il	MALE
naadir	MALE
naajy	MALE
naasih	MALE
naathim	MALE
naaz	FEMALE
nabarun	MALE
nabeeh	MALE
nabeeha	FEMALE
nabeel	MALE
nabeela	FEMALE
nabendu	MALE
nabhan	MALE
nabhendu	MALE
nabhi	FEMALE
nabhi	MALE
nabhij	MALE
nabhya	MALE
nachiket	MALE
nachiketa	MALE
nachni	FEMALE
nada	FEMALE
nadeeda	FEMALE
nadeem	MALE
nadezda	FEMALE
nadezhda	FEMALE
nadhinee	FEMALE
nadia	FEMALE
nadir	MALE
nadira	FEMALE
nadish	MALE
nadjet	FEMALE
nadwa	FEMALE
naeem	MALE
naeema	FEMALE
nafeesa	FEMALE
naftali	MALE
naganori	MALE
nagaraj	MALE
nagarjuna	MALE
nagendra	MALE
nagesh	MALE
naggar	MALE
nagina	FEMALE
nahla	FEMALE
naho	FEMALE
nahoko	FEMALE
nahum	MALE
nahusha	MALE
naija	FEMALE
naila	FEMALE
naimath	MALE
naina	FEMALE
nainika	FEMALE
nairit	MALE
naisha	FEMALE
naishadh	MALE
naishadha	FEMALE
naishi	FEMALE
naiya	FEMALE
naizen	MALE
najaah	FEMALE
najat	FEMALE
najeeb	MALE
najeeba	FEMALE
najeh	MALE
najiya	FEMALE
najla	FEMALE
najm	MALE
najma	FEMALE
najwa	FEMALE
najya	FEMALE
nakamaro	MALE
nakazo	MALE
nakshatra	MALE
nakul	MALE
nalesh	MALE
nalika	FEMALE
nalin	MALE
nalinaksha	MALE
nalini	FEMALE
namaha	FEMALE
naman	MALE
namboku	MALE
namdev	MALE
namhee	FEMALE
nami	FEMALE
namie	FEMALE
namika	FEMALE
namiko	FEMALE
namit	MALE
namita	FEMALE
namith	MALE
namiyo	FEMALE
nampo	MALE
namrata	FEMALE
namya	FEMALE
nana	FEMALE
nanak	MALE
nanako	FEMALE
nanami	FEMALE
nancy	FEMALE
nand	MALE
nanda	FEMALE
nanda	MALE
nandan	MALE
nandana	FEMALE
nandha	FEMALE
nandhinee	FEMALE
nandi	FEMALE
nandi	MALE
nandika	FEMALE
nandini	FEMALE
nandish	MALE
nandita	FEMALE
nando	MALE
nandu	MALE
nanneke	FEMALE
nano	FEMALE
nanu	MALE
nao	FEMALE
naoaki	MALE
naofumi	MALE
naohiko	MALE
naohiro	MALE
naoki	MALE
naoko	FEMALE
naomi	FEMALE
naomichi	MALE
naonobu	MALE
naonori	MALE
naora	FEMALE
naosuke	MALE
naotau	MALE
naoto	MALE
naoya	MALE
naoyuki	MALE
naozane	MALE
narahari	MALE
narahiko	MALE
narasimha	MALE
narayan	MALE
narayana	MALE
narayanan	MALE
narayani	FEMALE
naren	MALE
narendra	MALE
naresh	MALE
narhari	MALE
nari	FEMALE
nariaki	MALE
nariakira	MALE
narihari	MALE
narihira	MALE
nariko	FEMALE
narine	MALE
narita	FEMALE
narjes	FEMALE
narmad	MALE
narmada	FEMALE
narois	FEMALE
narottam	MALE
narpati	MALE
narpendyah	FEMALE
narsimha	MALE
nartan	FEMALE
nartan	MALE
naruaki	MALE
naruhiko	MALE
narumi	FEMALE
naruna	MALE
naseem	MALE
naseen	FEMALE
nashida	FEMALE
nashita	FEMALE
nasiha	FEMALE
nasira	FEMALE
nasser	MALE
natasa	FEMALE
natasha	FEMALE
nate	MALE
natesh	MALE
nathan	MALE
natheer	MALE
natraj	MALE
natsu	MALE
natsuki	FEMALE
natsuko	FEMALE
natsume	MALE
natsumi	FEMALE
natsuo	MALE
natun	FEMALE
natwar	MALE
nauka	FEMALE
navaj	MALE
naval	MALE
navami	FEMALE
navaneet	MALE
navaneeta	FEMALE
navashree	FEMALE
navdeep	MALE
navdha	FEMALE
naveen	MALE
naveena	FEMALE
naveshni	FEMALE
naveta	FEMALE
navin	MALE
navneet	MALE
navnit	MALE
navot	MALE
navraj	MALE
navrang	MALE
navroz	MALE
navtej	MALE
navya	FEMALE
nawal	FEMALE
nawar	FEMALE
nawfal	MALE
nayaab	MALE
nayakan	MALE
nayan	MALE
nayana	FEMALE
nayanesh	MALE
nayani	FEMALE
nayantara	FEMALE
nayoko	FEMALE
nazaaha	FEMALE
nazah	MALE
nazarha	FEMALE
nazeeh	MALE
nazeeha	FEMALE
nazeera	FEMALE
nazeeya	FEMALE
nazima	FEMALE
nazneen	FEMALE
neculai	MALE
neeharika	FEMALE
neel	MALE
neela	FEMALE
neelabja	FEMALE
neeladri	MALE
neelakshi	FEMALE
neelam	FEMALE
neelam	MALE
neelambar	MALE
neelanjan	MALE
neelanjana	FEMALE
neelesh	FEMALE
neelesh	MALE
neelima	FEMALE
neelkamal	FEMALE
neelkanta	MALE
neelkanth	MALE
neelmadhav	MALE
neelmani	MALE
neelotpal	MALE
neelu	FEMALE
neena	FEMALE
neepa	FEMALE
neera	FEMALE
neeraf	MALE
neeraj	MALE
neeraja	FEMALE
neeru	FEMALE
neeta	FEMALE
neeti	FEMALE
neetu	FEMALE
neha	FEMALE
nehal	FEMALE
neharika	FEMALE
neil	MALE
nelleke	FEMALE
nello	MALE
nene	FEMALE
nerea	FEMALE
nerisha	FEMALE
nesayem	FEMALE
netra	FEMALE
netravati	FEMALE
nevedha	FEMALE
niamh	FEMALE
nibaal	FEMALE
nibodh	MALE
nichelle	FEMALE
nichiren	MALE
nicholas	MALE
nico	MALE
nicoletta	FEMALE
nicos	MALE
nida	FEMALE
nidhi	FEMALE
nidhish	MALE
nidra	FEMALE
niegel	MALE
niels	MALE
nigam	MALE
nihal	MALE
nihar	MALE
niharika	FEMALE
nikash	MALE
nikesh	MALE
niket	MALE
nikhar	MALE
nikhat	MALE
nikhil	MALE
nikhilesh	MALE
nikhita	FEMALE
nikiforos	MALE
nikita	FEMALE
nikki	FEMALE
nikki	MALE
nikko	MALE
niklas	MALE
niko	MALE
nikola	MALE
nikolai	MALE
nikolaj	MALE
nikolaos	MALE
nikolas	MALE
nikos	MALE
nikunj	MALE
nikunja	MALE
nilabh	MALE
niladri	MALE
nilakshi	FEMALE
nilambari	FEMALE
nilanjana	FEMALE
nilasha	FEMALE
nilay	MALE
nilaya	FEMALE
nileen	FEMALE
nilesh	MALE
nilima	FEMALE
niloufer	FEMALE
niloy	MALE
nils	MALE
nilutha	FEMALE
nima	FEMALE
nimaat	FEMALE
nimai	MALE
nimi	FEMALE
nimish	MALE
nimisha	FEMALE
nimmit	MALE
nina	FEMALE
ninad	MALE
ninarika	FEMALE
ninsei	MALE
niou	MALE
nipa	FEMALE
nipun	MALE
nir	MALE
nirad	MALE
niraj	MALE
nirajit	MALE
niral	FEMALE
niral	MALE
nirali	FEMALE
niramay	MALE
niramitra	MALE
niranjan	MALE
niranjana	FEMALE
nirav	MALE
nirbhay	MALE
nirbhik	MALE
nirek	MALE
nirijhar	MALE
nirja	FEMALE
nirmal	MALE
nirmala	FEMALE
nirmalya	MALE
nirmay	MALE
nirmayi	FEMALE
nirmit	MALE
nirmohi	MALE
nirosha	FEMALE
nirupa	FEMALE
nirupam	MALE
nirupama	FEMALE
nirvan	MALE
nischal	MALE
nischay	MALE
nisha	FEMALE
nishad	MALE
nishanath	MALE
nishant	MALE
nishanthi	FEMALE
nishat	MALE
nishay	FEMALE
nisheeta	FEMALE
nishesh	MALE
nishi	FEMALE
nishikanta	MALE
nishit	MALE
nishita	FEMALE
nishita	MALE
nishith	MALE
nishithini	FEMALE
nishka	FEMALE
nishok	MALE
nishtha	FEMALE
nishthavant	MALE
nissho	MALE
nissim	MALE
niswarth	MALE
nita	FEMALE
niteesh	MALE
nitesh	MALE
niti	FEMALE
nitin	MALE
nitish	MALE
nitya	FEMALE
nityagopal	MALE
nityanand	MALE
nityananda	MALE
nityanta	MALE
nityapriya	FEMALE
nityasundar	MALE
nivedita	FEMALE
niveditha	FEMALE
nivedya	MALE
nivriti	FEMALE
nivritti	FEMALE
nivrutti	MALE
niyati	FEMALE
niyu	FEMALE
nizar	MALE
nkosi	MALE
no&#233	FEMALE
noa	FEMALE
nobo	MALE
noboru	MALE
nobu	MALE
nobuaki	MALE
nobuatsu	MALE
nobuharu	MALE
nobuhiko	MALE
nobuhisa	MALE
nobuhito	MALE
nobukazu	MALE
nobuko	FEMALE
nobuo	MALE
noburo	MALE
noburu	MALE
nobusuke	MALE
nobutaka	MALE
nobuyasu	MALE
nobuyoki	MALE
nobuyori	MALE
nobuyoshi	MALE
nobuyuki	MALE
noemie	FEMALE
noguchi	MALE
nomi	FEMALE
nooh	MALE
noopur	FEMALE
noor	FEMALE
noor	MALE
noori	MALE
noorjehan	FEMALE
nooruddin	MALE
nori	FEMALE
nori	MALE
noriaki	MALE
norie	FEMALE
norihide	MALE
norihiro	MALE
norihisa	MALE
norihito	MALE
norikazu	MALE
noriko	FEMALE
norinaga	MALE
norio	MALE
norishige	MALE
noritada	MALE
noritoshi	MALE
noriyori	MALE
noriyoshi	MALE
noriyuki	MALE
norogumi	MALE
norwood	MALE
nouf	FEMALE
nozomi	FEMALE
nridev	MALE
nrip	MALE
nripa	MALE
nripendra	MALE
nripesh	MALE
nu'man	MALE
nudhar	FEMALE
nuha	FEMALE
nuno	MALE
nupoor	FEMALE
nupur	FEMALE
nupura	FEMALE
nuria	FEMALE
nurit	FEMALE
nusayba	FEMALE
nusrat	FEMALE
nutan	FEMALE
nuzha	FEMALE
nyoko	FEMALE
oana	FEMALE
obalesh	MALE
ochiyo	FEMALE
oda	MALE
odbayar	MALE
odile	FEMALE
oditi	FEMALE
oeshi	FEMALE
ofer	MALE
ogai	MALE
ognyan	MALE
oharu	FEMALE
ohm	MALE
oier	MALE
oja	FEMALE
ojal	FEMALE
ojas	MALE
ojasvi	FEMALE
ojaswini	FEMALE
ojayit	MALE
okakura	MALE
okan	MALE
oki	FEMALE
okichi	FEMALE
okiku	FEMALE
okitsugu	MALE
oksana	FEMALE
okura	MALE
okyoito	MALE
olac	MALE
olatz	FEMALE
ole	MALE
oleksandr	MALE
olena	FEMALE
olevia	FEMALE
olivia	FEMALE
olivier	MALE
oliviero	MALE
om	MALE
oma	FEMALE
omair	MALE
omaira	FEMALE
omaja	FEMALE
omana	FEMALE
omanand	MALE
omar	MALE
omeir	MALE
omesh	MALE
omeshwar	MALE
omezo	MALE
omisha	FEMALE
omitsu	FEMALE
omja	MALE
omkar	MALE
omkarnath	MALE
omprakash	MALE
omran	MALE
omrao;	MALE
omri	MALE
omswaroop	MALE
ond&#345	MALE
ond??ej	MALE
ondrej	MALE
oni	FEMALE
oniji	MALE
onur	MALE
oojam	MALE
oorja	FEMALE
oorjit	MALE
ophelia	FEMALE
orest	MALE
orin	MALE
orino	FEMALE
orinosuke	MALE
orochi	MALE
osama	MALE
osamu	MALE
oshin	FEMALE
oshma	FEMALE
oskar	MALE
oskari	MALE
osman;	MALE
ossama	MALE
otakar	MALE
otojiro	MALE
otsu	FEMALE
otsune	FEMALE
ovais	MALE
ovia	FEMALE
owais	MALE
ozgur	MALE
ozlem	FEMALE
p?ter	MALE
paavan	MALE
padam	MALE
padma	FEMALE
padmaj	MALE
padmaja	FEMALE
padmajai	FEMALE
padmakali	FEMALE
padmal	FEMALE
padmalaya	FEMALE
padmalochana	FEMALE
padman	MALE
padmanabh	MALE
padmanabha	MALE
padmapati	MALE
padmavati	FEMALE
padmayani	MALE
padmesh	MALE
padmini	FEMALE
padminish	MALE
padnuni	FEMALE
pahal	FEMALE
paisarn	MALE
pakhi	FEMALE
pakshi	FEMALE
palak	FEMALE
palak	MALE
palash	MALE
palashkusum	MALE
palashranjan	MALE
palin	MALE
pallab	MALE
pallav	MALE
pallavi	FEMALE
pallavini	FEMALE
paloma	FEMALE
pamela	FEMALE
pampa	FEMALE
panagiotis	MALE
panav	MALE
panayiotis	MALE
panchal	MALE
panchali	FEMALE
panchanan	MALE
pandhari	MALE
pandi	MALE
panduranga	MALE
panini	FEMALE
panini	MALE
pankaj	MALE
pankaja	FEMALE
pankajam	FEMALE
pankajan	MALE
pankhadi	FEMALE
pankhuri	FEMALE
pankita	FEMALE
pankti	FEMALE
panna	FEMALE
pannalal	MALE
panshul	MALE
paolo	MALE
papiha	FEMALE
parag	MALE
parakram	MALE
param	MALE
parama	FEMALE
paramananda	MALE
paramartha	MALE
paramesh	MALE
parameshwari	FEMALE
paramhans	MALE
paramhansa	MALE
paramita	FEMALE
paramjeet	MALE
paramjit	MALE
paramveer	MALE
paranjay	MALE
parantapa	MALE
parashar	MALE
parashuram	MALE
parasmani	MALE
paravasu	MALE
parbarti	FEMALE
parees	MALE
paresh	MALE
pari	FEMALE
paridhi	FEMALE
parijat	MALE
pariket	MALE
parikshit	MALE
parimal	MALE
parindra	MALE
parinita	FEMALE
parishi	FEMALE
parita	FEMALE
paritosh	MALE
pariyat	FEMALE
parkash	MALE
parmameshwar	MALE
parmeet	MALE
parmesh	MALE
parmita	FEMALE
parnad	MALE
parnal	FEMALE
parnashri	FEMALE
parni	FEMALE
parnik	FEMALE
parnika	FEMALE
parth	MALE
partha	MALE
parthapratim	MALE
parthavi	FEMALE
parthiv	MALE
parthivi	FEMALE
parul	FEMALE
parvani	FEMALE
parvati	FEMALE
parvatinandan	MALE
parveen	FEMALE
parvesh	MALE
pascal	MALE
pascale	FEMALE
pasha	FEMALE
pashupati	MALE
pat	MALE
patag	MALE
patakin	MALE
patala	FEMALE
patanjali	MALE
pathik	MALE
pathin	MALE
patmanjari	FEMALE
patoj	MALE
patralekha	FEMALE
patralika	MALE
patricio	MALE
patrik	MALE
patrizia	FEMALE
paula	FEMALE
paulo	MALE
pavak	MALE
pavaki	FEMALE
pavan	MALE
pavana	FEMALE
pavanaj	MALE
pavani	FEMALE
pavani	MALE
pavanjit	MALE
paveena	FEMALE
pavel	MALE
pavitra	FEMALE
pavitra	MALE
pavlina	FEMALE
pawan	MALE
paweena	FEMALE
pawel	MALE
payal	FEMALE
payas	MALE
payod	MALE
payoja	FEMALE
peer	MALE
peeyush	MALE
pehlaj	MALE
penka	FEMALE
per	MALE
per-kristian	MALE
pernilla	FEMALE
pernita	FEMALE
peter-arno	MALE
petr	MALE
petra-maria	FEMALE
petter	MALE
petya	FEMALE
pezan	MALE
phalak	MALE
phalguni	MALE
phanindra	MALE
phenil	MALE
philipp	MALE
philippe	MALE
phillipe	MALE
philomena	FEMALE
phiroza	FEMALE
phoolan	FEMALE
phyllis	FEMALE
pi-chuan	FEMALE
pia	FEMALE
pichuan	FEMALE
piek	MALE
piercarlo	MALE
pierluigi	MALE
piero	MALE
pierpaolo	MALE
pierre-joseph	MALE
pierre-sylvain	MALE
pierre-yves	MALE
pierrette	FEMALE
piet	MALE
pieter	MALE
pietro	MALE
piki	FEMALE
pinak	MALE
pinaki	MALE
pinakin	MALE
pinar	FEMALE
pinga	FEMALE
pingala	FEMALE
pingla	FEMALE
pinkesh	MALE
pinky	FEMALE
piotr	MALE
pirmohammed	MALE
piroska	FEMALE
pitambar	MALE
pius	MALE
pival	FEMALE
piyali	FEMALE
piyush	MALE
plauch&#233	FEMALE
plava	FEMALE
pogula	MALE
pontus	MALE
pooja	FEMALE
poojan	MALE
poojit	MALE
poonam	FEMALE
poonish	MALE
poorbi	FEMALE
poorna	FEMALE
poorna	MALE
poornachandra	MALE
poornima	FEMALE
poorvi	FEMALE
porush	MALE
posh	MALE
poul	MALE
poulomi	FEMALE
poushali	FEMALE
prabal	MALE
prabha	FEMALE
prabhakar	MALE
prabhas	MALE
prabhat	MALE
prabhati	FEMALE
prabhav	MALE
prabhu	MALE
prabir	MALE
prabodh	MALE
prabodhan	MALE
prabuddha	MALE
pracheeta	FEMALE
prachet	MALE
prachi	FEMALE
prachur	MALE
prachya	MALE
pradeep	MALE
pradeepta	FEMALE
pradhi	MALE
pradhyumna	MALE
pradip	MALE
pradipta	MALE
pradnesh	MALE
pradnya	FEMALE
pradosh	MALE
prady	MALE
pradyot	MALE
pradyumna	MALE
pradyun	MALE
praful	MALE
prafula	FEMALE
prafull	MALE
prafulla	MALE
pragalbha	FEMALE
pragati	FEMALE
pragun	MALE
pragya	FEMALE
pragyaparamita	FEMALE
pragyawati	FEMALE
prahalad	MALE
prahlad	MALE
prajakta	FEMALE
prajeet	MALE
prajesh	MALE
prajin	MALE
prajit	MALE
prajna	FEMALE
prakash	MALE
prakat	MALE
praket	MALE
prakhar	MALE
prakher	MALE
prakhyat	MALE
prakrit	MALE
prakriti	FEMALE
prakriti	MALE
prakruthi	FEMALE
prakruti	FEMALE
prakshi	FEMALE
prakul	MALE
pralay	MALE
prama	FEMALE
pramada	FEMALE
pramath	MALE
pramesh	MALE
pramila	FEMALE
pramit	MALE
pramiti	FEMALE
pramod	MALE
pramodan	MALE
pran	MALE
pranad	MALE
pranali	FEMALE
pranati	FEMALE
pranav	MALE
pranavi	FEMALE
pranay	MALE
praneel	MALE
praneeth	MALE
pranesh	MALE
pranet	MALE
pranit	MALE
pranita	FEMALE
pranjal	FEMALE
pranjal	MALE
pranjivan	MALE
pransukh	MALE
prapti	FEMALE
prarthana	FEMALE
prasad	MALE
prasanna	MALE
prasata	MALE
prasenjit	MALE
prasham	MALE
prashansa	FEMALE
prashant	MALE
prashanta	MALE
prashanth	MALE
prashanti	FEMALE
prasheetha	FEMALE
prasheila	FEMALE
prasit	MALE
prasoon	MALE
prasun	MALE
pratap	MALE
prateek	MALE
prateep	MALE
prateet	MALE
pratha	MALE
pratham	MALE
prathamesh	MALE
prathish	MALE
prathvi	MALE
prathyush	MALE
pratibha	FEMALE
pratigya	FEMALE
pratik	MALE
pratima	FEMALE
pratishtha	FEMALE
pratiti	FEMALE
pratiti	MALE
pratosh	MALE
pratul	MALE
pratyush	MALE
pratyusha	FEMALE
praval	MALE
pravalika	FEMALE
pravar	MALE
praveen	MALE
praveena	FEMALE
praver	MALE
pravesh	MALE
pravin	MALE
pravir	MALE
pravit	MALE
prayag	MALE
prayerna	FEMALE
preenithi	FEMALE
preet	MALE
preeti	FEMALE
preetish	MALE
preksha	FEMALE
prem	FEMALE
prem	MALE
prema	FEMALE
premal	MALE
premala	FEMALE
premanand	MALE
premendra	MALE
premila	FEMALE
prerana	FEMALE
prerna	FEMALE
preslav	MALE
preyakshana	FEMALE
preyasi	FEMALE
prianka	FEMALE
prina	FEMALE
prisha	FEMALE
prishita	FEMALE
prita	FEMALE
prital	FEMALE
pritam	MALE
pritesh	MALE
pritha	FEMALE
prithika	FEMALE
prithish	MALE
prithu	MALE
prithvi	MALE
prithviraj	MALE
priti	FEMALE
pritika	FEMALE
pritikana	FEMALE
pritilata	FEMALE
priya	FEMALE
priya	MALE
priyabrata	MALE
priyadarshini	FEMALE
priyakankshi	FEMALE
priyal	FEMALE
priyam	FEMALE
priyam	MALE
priyamvada	FEMALE
priyanka	FEMALE
priyaranjan	MALE
promila	FEMALE
pu-jen	MALE
puja	FEMALE
pujan	MALE
puji	FEMALE
pujit	MALE
pujita	FEMALE
pujitha	FEMALE
pukhraj	MALE
pulak	FEMALE
pulak	MALE
pulakesh	MALE
pulastya	MALE
pulin	MALE
pulish	MALE
pulkit	MALE
puloma	FEMALE
punam	FEMALE
punarnava	FEMALE
pundarik	MALE
puneet	MALE
punit	MALE
punita	FEMALE
punthali	FEMALE
punya	FEMALE
punyabrata	MALE
punyasloka	MALE
purahan	MALE
purajit	MALE
puran	MALE
purandar	MALE
puranjay	MALE
purnanada	MALE
purnendu	MALE
purnima	FEMALE
purshottam	MALE
puru	MALE
purujit	MALE
purumitra	MALE
pururava	MALE
purushottam	MALE
purva	FEMALE
purvaja	FEMALE
purvi	FEMALE
pusha	FEMALE
pushkal	MALE
pushkar	MALE
pushpa	FEMALE
pushpak	MALE
pushpanjali	FEMALE
pushpendu	MALE
pushpesh	MALE
pushpita	FEMALE
puskara	MALE
pusti	FEMALE
putta	MALE
putul	FEMALE
pyarelal	MALE
pyaremohan	MALE
pyas	FEMALE
pyas	MALE
qasim	MALE
qatadah	MALE
qays	MALE
quamar	MALE
quarrtulain	FEMALE
quasar	FEMALE
quasim	MALE
qudamah	MALE
qutaybah	MALE
qutub	MALE
r?diger	MALE
ra'ed	MALE
ra?l	MALE
raadhika	FEMALE
raahi	MALE
raaida	FEMALE
raakhi	FEMALE
raakin	MALE
raamiz	MALE
raashi	FEMALE
raatib	MALE
raawiya	FEMALE
rabab	FEMALE
rabah	MALE
rabani	FEMALE
rabee	MALE
rabeea	FEMALE
rabhya	FEMALE
rabia	FEMALE
rachana	FEMALE
rachel	FEMALE
rachi	FEMALE
rachita	FEMALE
rachmat	MALE
rachna	FEMALE
rada	FEMALE
radek	MALE
radha	FEMALE
radhakanta	MALE
radhakrishna	MALE
radhakrishnan	MALE
radhavallabh	MALE
radhesh	MALE
radheshyam	MALE
radhey	MALE
radheya	MALE
radhika	FEMALE
radhiyaa	FEMALE
radhwa	FEMALE
rados	MALE
rados??aw	MALE
radoslav	MALE
radu	MALE
rafa	FEMALE
rafael	MALE
rafee'	MALE
rafey	MALE
raffaella	FEMALE
rafiya	FEMALE
ragavarshini	FEMALE
ragesh	MALE
raghav	MALE
raghavendra	MALE
raghd	FEMALE
ragheb	MALE
raghu	MALE
raghunandan	MALE
raghunath	MALE
raghupati	MALE
raghuveer	MALE
raghuvir	MALE
ragi	FEMALE
ragini	FEMALE
ragish	MALE
rahas	MALE
rahat	FEMALE
rahel	FEMALE
rahini	FEMALE
rahman	MALE
rahmatullah	MALE
rahul	MALE
rai	MALE
raicho	FEMALE
raiden	MALE
raidon	MALE
rainer	MALE
raisa	FEMALE
raj	MALE
raja	FEMALE
raja	MALE
raja noor	FEMALE
rajab	MALE
rajalakshmi	FEMALE
rajam	MALE
rajan	MALE
rajani	FEMALE
rajani	MALE
rajanigandha	FEMALE
rajanikant	MALE
rajanikanta	MALE
rajarshi	MALE
rajas	MALE
rajasekar	MALE
rajat	MALE
rajata	FEMALE
rajath	MALE
rajatshubhra	MALE
rajdeep	MALE
rajdulari	FEMALE
rajdulari	MALE
rajeet	MALE
rajeev	MALE
rajendra	MALE
rajendrakumar	MALE
rajendramohan	MALE
rajesh	MALE
rajeshri	FEMALE
rajeshwari	FEMALE
rajhans	FEMALE
raji	FEMALE
rajib	MALE
rajika	FEMALE
rajit	MALE
rajiv	MALE
rajivlochan	MALE
rajivnayan	MALE
rajkumar	MALE
rajkumari	FEMALE
rajnandhini	FEMALE
rajni	FEMALE
rajnish	MALE
rajrishi	MALE
rajrita	FEMALE
rajshri	FEMALE
rajul	FEMALE
rajyeshwar	MALE
raka	FEMALE
rakesh	MALE
rakhi	FEMALE
rakishi	MALE
raksha	FEMALE
raksha	MALE
rakshak	MALE
rakshan	MALE
rakshita	FEMALE
rakti	FEMALE
raku	FEMALE
ralf	MALE
ram	MALE
rama	FEMALE
ramadeep	MALE
ramadut	MALE
ramakanta	MALE
raman	MALE
ramani	FEMALE
ramanuj	MALE
ramanuja	MALE
ramarathnam	MALE
ramashray	MALE
ramavatar	MALE
rambha	FEMALE
ramchandra	MALE
ramesh	MALE
rameshwar	MALE
rameshwari	FEMALE
rami	FEMALE
ramita	FEMALE
ramkishore	MALE
ramkrishna	MALE
ramkumar	MALE
rammohan	MALE
ramnath	MALE
ramprasad	MALE
rampratap	MALE
ramra	FEMALE
ramratan	MALE
ramswaroop	MALE
ramu	MALE
ramya	FEMALE
ramzi	MALE
ran	FEMALE
rana	MALE
ranajay	MALE
ranajit	MALE
ranak	MALE
rand	FEMALE
randhir	MALE
randolf	MALE
ranesh	MALE
rangan	MALE
rangana	FEMALE
ranganath	MALE
rangesh	MALE
ranhita	FEMALE
rani	FEMALE
ranita	FEMALE
raniya	FEMALE
ranjan	FEMALE
ranjan	MALE
ranjana	FEMALE
ranjeet	MALE
ranjini	FEMALE
ranjit	MALE
ranjita	FEMALE
ranjith	MALE
ranjiv	MALE
ranju	FEMALE
ranveer	MALE
ranya	FEMALE
raoul	MALE
raqueliza	FEMALE
rasaraj	MALE
rasbihari	MALE
rasesh	MALE
rasha	FEMALE
rashad	MALE
rasheeda	FEMALE
rashi	FEMALE
rashid	MALE
rashika	FEMALE
rashmi	FEMALE
rashmika	FEMALE
rashmil	MALE
rasik	MALE
rasika	FEMALE
rasmaru	MALE
rasna	FEMALE
rasul	MALE
ratan	MALE
ratannabha	MALE
rathin	MALE
rathna	FEMALE
rati	FEMALE
ratish	MALE
ratna	FEMALE
ratnabala	FEMALE
ratnabali	FEMALE
ratnabhu	MALE
ratnajyouti	FEMALE
ratnakar	MALE
ratnalekha	FEMALE
ratnali	FEMALE
ratnamala	FEMALE
ratnangi	FEMALE
ratnanidhi	MALE
ratnaprabha	FEMALE
ratnapriya	FEMALE
ratnavali	FEMALE
ratnesh	MALE
ratul	MALE
raunak	MALE
ravali	FEMALE
raveena	FEMALE
ravi	MALE
ravikiran	MALE
ravikumar	MALE
ravin	MALE
ravinandan	MALE
ravindhar	MALE
ravindra	MALE
ravindranath	MALE
raviprabha	FEMALE
ravish	MALE
ravishu	MALE
rawdha	FEMALE
ray	MALE
raya	FEMALE
rayirth	MALE
raymonde	MALE
raza	MALE
razak	MALE
razan	MALE
razvan	MALE
rebanta	MALE
rebha	FEMALE
rechal	FEMALE
reedh	MALE
reem	FEMALE
reema	FEMALE
reena	FEMALE
reeya	FEMALE
rehana	FEMALE
reheila	FEMALE
rehman	MALE
rehmat	MALE
rei	FEMALE
rei	MALE
reijiro	MALE
reiko	FEMALE
reina	FEMALE
reinhard	MALE
reinhart	MALE
reinhold	MALE
reizo	MALE
rekha	FEMALE
remco	MALE
remi	MALE
remko	MALE
remo	MALE
ren	FEMALE
renesh	MALE
renjiro	MALE
rens	MALE
renu	FEMALE
renuka	FEMALE
renzo	MALE
resha	FEMALE
resham	FEMALE
reshma	FEMALE
reshmi	FEMALE
reut	FEMALE
reva	FEMALE
revati	FEMALE
rewa	FEMALE
reya	FEMALE
reyna	FEMALE
reza	MALE
rhea	FEMALE
rhyah	FEMALE
ria	FEMALE
rich&#225	MALE
rich?rd	MALE
richa	FEMALE
rickard	MALE
ricky	MALE
riddhi	FEMALE
riddhiman	MALE
ridha	MALE
ridhwan	MALE
rie	FEMALE
rieko	FEMALE
rieks	MALE
rigardt	MALE
riina	FEMALE
riju	FEMALE
rijul	FEMALE
rijul	MALE
rijuta	FEMALE
rik	MALE
rika	FEMALE
rikako	FEMALE
rikhil	MALE
rikin	MALE
rikiya	MALE
riko	FEMALE
riku	FEMALE
riku	MALE
rikuto	MALE
rikyu	MALE
rima	FEMALE
rimjhim	FEMALE
rimpy	FEMALE
rin	FEMALE
rina	FEMALE
rinako	FEMALE
rinesh	MALE
ringo	MALE
rini	FEMALE
rinji	MALE
rinku	FEMALE
rino	FEMALE
rintaro	MALE
rio	FEMALE
rion	MALE
ripal	MALE
ripudaman	MALE
risa	FEMALE
risako	FEMALE
rishabh	MALE
rishi	MALE
rishika	FEMALE
rishikesh	MALE
rishima	FEMALE
rishit	MALE
rishita	FEMALE
rishvanjas	MALE
risto	MALE
rita	FEMALE
ritesh	MALE
rithwik	MALE
riti	FEMALE
ritika	FEMALE
ritoma	FEMALE
ritsuko	FEMALE
ritu	FEMALE
rituparan	MALE
rituraj	MALE
ritvik	MALE
rivan	MALE
riya	FEMALE
riyad	MALE
riyadh	MALE
riyaz	MALE
rizmi	FEMALE
rizvan	MALE
rizwan	MALE
rkuemon	MALE
robbert	MALE
robert	MALE
robun	MALE
rochak	MALE
rochan	MALE
rochana	FEMALE
rochi	FEMALE
roeland	MALE
roger	MALE
rohak	MALE
rohan	MALE
rohanlal	MALE
rohini	FEMALE
rohiniraman	MALE
rohinish	MALE
rohit	MALE
rohita	FEMALE
rohitasva	MALE
rohtak	MALE
rohtash	MALE
roja	FEMALE
roka	MALE
roku	MALE
rokuro	MALE
roma	FEMALE
romaric	MALE
romesh	MALE
romi	FEMALE
romila	FEMALE
romir	MALE
romit	MALE
ronak	MALE
ronaldo	MALE
ronan	MALE
ronen	MALE
ronnie	MALE
rooma	FEMALE
roopa	FEMALE
rosanjin	MALE
roser	FEMALE
roshan	FEMALE
roshan	MALE
roshana	FEMALE
roshni	FEMALE
rossana	FEMALE
rossitza	FEMALE
rosy	FEMALE
rouble	FEMALE
roussanaly	MALE
rowan	MALE
rownak	MALE
rozmin	FEMALE
ru-yng	FEMALE
rub?n	MALE
rubaina	FEMALE
rubesh	MALE
ruchi	FEMALE
ruchika	FEMALE
ruchir	MALE
ruchira	FEMALE
ruchit	MALE
ruchita	FEMALE
rudi	MALE
rudiger	MALE
rudra	MALE
rudrani	FEMALE
rudrapriya	FEMALE
ruhan	MALE
ruhani	FEMALE
ruhi	MALE
ruhin	FEMALE
rui	MALE
rujul	MALE
rujuta	FEMALE
rukan	FEMALE
rukhmini	FEMALE
rukma	FEMALE
rukminesh	MALE
rukmini	FEMALE
ruksana	FEMALE
ruma	FEMALE
rumiko	FEMALE
run	FEMALE
rune	MALE
rupa	FEMALE
rupak	MALE
rupal	FEMALE
rupali	FEMALE
rupang	MALE
rupashi	FEMALE
rupashri	FEMALE
rupendra	MALE
rupesh	MALE
rupeshwar	MALE
rupeshwari	FEMALE
rupika	FEMALE
rupin	MALE
ruqaya	FEMALE
ruri	FEMALE
ruriko	FEMALE
rushabh	MALE
rusham	FEMALE
rushi	MALE
rushil	MALE
ruslan	MALE
rustom	MALE
ruthvik	MALE
rutuja	FEMALE
rutujit	MALE
rutva	FEMALE
rutveg	MALE
ruwayda	FEMALE
ruy	MALE
ruzhan	MALE
ryka	FEMALE
ryo	MALE
ryobe	MALE
ryochi	MALE
ryoichi	MALE
ryoji	MALE
ryoko	FEMALE
ryoma	MALE
ryosei	MALE
ryosuke	FEMALE
ryota	MALE
ryozo	MALE
ryszard	MALE
rytasha	FEMALE
ryu	MALE
ryuichi	MALE
ryuichiro	MALE
ryunosuke	MALE
ryushi	MALE
ryutaro	MALE
ryuu	MALE
ryuunosuke	MALE
ryuzaburo	MALE
s.r.k.	MALE
saabir	MALE
saabira	FEMALE
saachee	FEMALE
saad	MALE
saahil	MALE
saahir	MALE
saajid	MALE
saalih	MALE
saaliha	FEMALE
saalima	FEMALE
saamiya	FEMALE
saanjh	FEMALE
saanjh	MALE
saara	FEMALE
saariyah	MALE
saashi	FEMALE
saatvika	FEMALE
sabal	MALE
sabarish	MALE
sabeeh	MALE
sabiha	FEMALE
sabina	FEMALE
sabrang	FEMALE
sabrang	MALE
sabri	FEMALE
sabrina	FEMALE
saburo	MALE
sabyasachi	MALE
sacchidananda	MALE
sachchit	MALE
sachet	MALE
sachetan	MALE
sachi	FEMALE
sachi	MALE
sachiko	FEMALE
sachin	MALE
sachio	MALE
sachish	MALE
sachit	MALE
sachita	FEMALE
sachiv	MALE
sachiyo	FEMALE
sada	FEMALE
sadabhuja	FEMALE
sadabindu	MALE
sadaf	FEMALE
sadaharu	MALE
sadahige	MALE
sadako	FEMALE
sadakuno	MALE
sadanand	MALE
sadanobu	MALE
sadao	MALE
sadaoki	MALE
sadar	MALE
sadashiv	MALE
sadashiva	MALE
sadatake	MALE
sadavir	MALE
sadayoshi	MALE
sadeepan	MALE
sadeeq	MALE
sadgata	FEMALE
sadgati	FEMALE
sadgun	MALE
sadguna	FEMALE
sadhan	FEMALE
sadhana	FEMALE
sadhika	FEMALE
sadhil	MALE
sadhna	FEMALE
sadhvi	FEMALE
sadik	MALE
sadiq	MALE
sadiqua	FEMALE
sadiva	MALE
sadru	MALE
sadvita	FEMALE
sae	FEMALE
saee	FEMALE
saeed	MALE
saeeda	FEMALE
saeko	FEMALE
saemon	MALE
safa	FEMALE
safal	MALE
safia	FEMALE
safiy	MALE
safiya	FEMALE
safwan	MALE
sagan	MALE
sagar	MALE
sagarika	FEMALE
sagun	FEMALE
sagun	MALE
saguna	FEMALE
sahaj	MALE
sahana	FEMALE
sahar	MALE
sahara	MALE
saharika	FEMALE
saharsh	MALE
sahas	MALE
sahasrad	MALE
sahasya	MALE
sahat	MALE
sahaya	MALE
sahdev	MALE
saheli	FEMALE
sahib	MALE
sahiba	FEMALE
sahil	MALE
sahila	FEMALE
sahima	FEMALE
sahira	FEMALE
sahishnu	MALE
sahithi	FEMALE
sahla	FEMALE
sahoj	FEMALE
sai	FEMALE
sai	MALE
said	MALE
saif	MALE
saikaku	MALE
sailee	FEMALE
saima	FEMALE
sainath	MALE
saionji	MALE
saipraasad	MALE
saipratap	MALE
sairah	FEMALE
saisha	FEMALE
saito	FEMALE
sajal	MALE
sajala	FEMALE
sajan	MALE
sajani	FEMALE
sajib	MALE
sajiv	MALE
sajni	FEMALE
sakaleshwar	MALE
sakamae	FEMALE
sakash	MALE
sakeena	FEMALE
saket	MALE
sakhi	FEMALE
saki	FEMALE
sakiko	FEMALE
sakina	FEMALE
saksham	MALE
sakshi	FEMALE
sakshik	MALE
sakue	FEMALE
sakuko	FEMALE
sakura	FEMALE
sakurai	MALE
sakurako	FEMALE
sakuro	FEMALE
sakutaro	MALE
salah	MALE
salaman	MALE
salarjung	MALE
saleem	MALE
saleema	FEMALE
salem	MALE
salena	FEMALE
saleshni	FEMALE
saliha	FEMALE
salil	MALE
salila	FEMALE
salim	MALE
salima	FEMALE
salma	FEMALE
salman	MALE
saloni	FEMALE
salwa	FEMALE
sama	FEMALE
samaah	FEMALE
samabashiv	MALE
samaj	MALE
samajas	MALE
samali	FEMALE
samantha	FEMALE
samanyu	MALE
samapti	FEMALE
samar	FEMALE
samar	MALE
samarendra	MALE
samarendu	MALE
samarjeet	MALE
samarjit	MALE
samarth	MALE
samata	FEMALE
samavart	MALE
samba	MALE
sambaran	MALE
sambathkrishna	MALE
sambha	MALE
sambhav	MALE
sambhddha	MALE
sambit	MALE
samdarshi	MALE
sameeha	FEMALE
sameeksha	FEMALE
sameen	MALE
sameena	FEMALE
sameer	MALE
sameera	FEMALE
samendra	MALE
samendu	MALE
samer	MALE
samesh	MALE
samhita	FEMALE
samidha	FEMALE
samik	MALE
samika	FEMALE
samiksha	FEMALE
samin	MALE
samir	MALE
samira	FEMALE
samiran	MALE
samit	FEMALE
samit	MALE
samita	FEMALE
samiya	FEMALE
sammad	MALE
sampada	FEMALE
sampat	MALE
sampatti	FEMALE
sampriti	FEMALE
samrat	MALE
samruddhi	FEMALE
samrudh	MALE
samson	MALE
samudra	FEMALE
samudra	MALE
samudragupta	MALE
samudrasen	MALE
samvar	MALE
samy	MALE
samyak	MALE
samyukta	FEMALE
samyuktha	FEMALE
samyuktheswari	FEMALE
sana	FEMALE
sanabhi	MALE
sanae	FEMALE
sanako	FEMALE
sanam	FEMALE
sanam	MALE
sananda	FEMALE
sanat	MALE
sanatan	MALE
sanatani	FEMALE
sanaya	FEMALE
sanchala	FEMALE
sanchali	FEMALE
sanchay	MALE
sanchaya	FEMALE
sanchit	MALE
sanchita	FEMALE
sanda	FEMALE
sandananda	MALE
sandeep	MALE
sandeepen	MALE
sander	MALE
sandesh	MALE
sandhaya	FEMALE
sandhya	FEMALE
sandipan	MALE
sandiway	MALE
sandor	MALE
sandrine	FEMALE
sandro	MALE
sandy	MALE
saneatsu	MALE
sanemi	FEMALE
sanetomo	MALE
sang-bum	MALE
sang-kyu	MALE
sang-zoo	MALE
sangeeta	FEMALE
sangeetha	FEMALE
sangita	FEMALE
sangkeun	MALE
sangkyu	MALE
sango	FEMALE
sangyun	MALE
sani	FEMALE
sania	FEMALE
sanika	FEMALE
sanil	MALE
sanitha	FEMALE
saniya	FEMALE
sanjan	MALE
sanjana	FEMALE
sanjanthi	FEMALE
sanjay	MALE
sanjeev	MALE
sanjeevan	MALE
sanjesh	MALE
sanjika	FEMALE
sanjiro	MALE
sanjit	MALE
sanjita	FEMALE
sanjiv	MALE
sanjivan	MALE
sanjivani	FEMALE
sanjog	MALE
sanjoli	FEMALE
sanjukta	FEMALE
sanjula	FEMALE
sanjuro	MALE
sanjushree	FEMALE
sankalp	MALE
sankalpa	MALE
sankar	MALE
sankara	MALE
sankaran	MALE
sankarshan	MALE
sanket	MALE
sankul	FEMALE
sannath	MALE
sannidhi	FEMALE
sanobar	FEMALE
sanobar	MALE
sanoja	FEMALE
sanraku	MALE
sanshray	MALE
sansita	FEMALE
sanskriti	FEMALE
sanskruti	FEMALE
santan	MALE
santawana	FEMALE
santayani	FEMALE
santosh	FEMALE
santosh	MALE
santoshi	FEMALE
santushti	FEMALE
sanurag	MALE
sanvali	FEMALE
sanwari	FEMALE
sanwariya	MALE
sanya	FEMALE
sanyakta	FEMALE
sanyam	MALE
sanyog	MALE
sanyukta	FEMALE
sanzo	MALE
saori	FEMALE
sapan	MALE
saparna	FEMALE
saphala	FEMALE
sapna	FEMALE
saprathas	MALE
saptajit	MALE
saptanshu	MALE
saquib	MALE
sara	FEMALE
sarada	FEMALE
sarah	FEMALE
sarakshi	FEMALE
saral	MALE
sarala	FEMALE
sarama	FEMALE
sarang	MALE
saranya	FEMALE
saras	MALE
sarasa	FEMALE
sarasi	FEMALE
sarasija	MALE
sarasvat	MALE
sarasvati	FEMALE
saraswati	FEMALE
sarat	MALE
sarathi	MALE
saravati	FEMALE
sarayu	FEMALE
sarbajit	MALE
sarbani	FEMALE
sareewan	FEMALE
sarel	MALE
sarfaraz	MALE
sargam	MALE
sarika	FEMALE
sarin	MALE
sarish	MALE
sarit	FEMALE
sarita	FEMALE
sarjana	FEMALE
sarla	FEMALE
saroj	FEMALE
saroj	MALE
saroja	FEMALE
sarojin	MALE
sarojini	FEMALE
sartaj	MALE
sarthak	MALE
saruchi	FEMALE
sarup	MALE
sarupa	FEMALE
saruprani	FEMALE
sarva	MALE
sarvad	MALE
sarvadaman	MALE
sarvadev	MALE
sarvadharin	MALE
sarvag	MALE
sarvagjna	FEMALE
sarvak	MALE
sarvambh	MALE
sarvang	MALE
sarvashay	MALE
sarvavas	MALE
sarvbhanu	MALE
sarvendra	MALE
sarvesh	MALE
sarwar	MALE
saryu	FEMALE
sashang	MALE
sashank	MALE
sashi	FEMALE
sashreek	MALE
sashwat	MALE
sasi	MALE
sasmit	MALE
sasmita	FEMALE
sasthi	FEMALE
sasweet	MALE
sata	FEMALE
satadev	MALE
satamanyu	MALE
satanand	MALE
satanjeev	MALE
satesh	MALE
sathi	MALE
sathvika	FEMALE
sathyapriya	FEMALE
sati	FEMALE
satin	MALE
satinath	MALE
satinder	MALE
satindra	MALE
satish	MALE
satkartar	MALE
satoko	FEMALE
satomi	FEMALE
satoru	MALE
satoshi	MALE
satpal	MALE
satpati	MALE
satrajit	MALE
satrijit	MALE
satu	FEMALE
satvamohan	MALE
satvari	FEMALE
satvat	MALE
satveer	MALE
satvi	FEMALE
satvik	MALE
satviki	FEMALE
satvinder	MALE
satwaki	MALE
satya	FEMALE
satya	MALE
satyadev	MALE
satyajit	MALE
satyak	MALE
satyakam	MALE
satyaki	FEMALE
satyaki	MALE
satyam	MALE
satyamurty	MALE
satyanarayan	MALE
satyankar	MALE
satyaprakash	MALE
satyapriya	MALE
satyarupa	FEMALE
satyasheel	MALE
satyavan	MALE
satyavati	FEMALE
satyavrat	MALE
satyavrata	MALE
satyen	MALE
satyendra	MALE
saubal	MALE
saubhadra	MALE
saudamini	FEMALE
saumit	MALE
saumitra	MALE
saumya	FEMALE
saumya	MALE
saumyaa	FEMALE
saumyi	FEMALE
saura	FEMALE
saurabh	MALE
saurav	MALE
saurjyesh	MALE
savar	MALE
savarna	FEMALE
savio	MALE
savir	MALE
savit	MALE
savita	FEMALE
savitashri	FEMALE
savitendra	MALE
savitri	FEMALE
savya	MALE
sawako	FEMALE
sawan	MALE
sawao	MALE
sawda	FEMALE
sawini	FEMALE
sawsan	FEMALE
saya	FEMALE
sayam	MALE
sayan	MALE
sayantini	FEMALE
sayed	MALE
sayeeda	FEMALE
sayeesha	FEMALE
sayf	MALE
sayid	MALE
sayo	FEMALE
sayoko	FEMALE
sayori	FEMALE
sayuri	FEMALE
sazia	FEMALE
sean	MALE
sebasti?n	MALE
sebastiaan	MALE
sebastiana	FEMALE
sebastien	MALE
seeger	MALE
seema	FEMALE
seemanta	MALE
seemanti	FEMALE
seemantini	FEMALE
seena	FEMALE
seerat	FEMALE
sehej	MALE
sei	FEMALE
seibei	MALE
seiesnsui	MALE
seihachi	MALE
seiho	MALE
seiichi	MALE
seiji	MALE
seika	MALE
seiki	MALE
seiko	FEMALE
seinosuke	MALE
seiryo	MALE
seishi	MALE
seishiro	MALE
seishisai	MALE
seison	MALE
seitaro	MALE
sejal	FEMALE
seka	FEMALE
sekar	MALE
seki	FEMALE
sekien	MALE
selina	FEMALE
selma	FEMALE
selvi	FEMALE
semanti	FEMALE
sen	FEMALE
sen	MALE
senajit	MALE
senichi	MALE
seniz	FEMALE
senthil	MALE
senzo	MALE
seohyun	FEMALE
seok	MALE
seok mun	MALE
seokhwan	MALE
seong-bae	MALE
seongyong	MALE
seonho	MALE
seonhwa	FEMALE
sepandar	MALE
serena	FEMALE
serge	MALE
sergei	MALE
sergey	MALE
seshu	MALE
sessue	MALE
setsuko	FEMALE
setsuo	MALE
settan	MALE
setu	FEMALE
setu	MALE
seung shik	MALE
seung-hoon	MALE
seung-wook	MALE
seunghi	MALE
seungho	MALE
seungmi	FEMALE
seungwoo	MALE
seva	FEMALE
sevak	MALE
sevati	FEMALE
sevita	FEMALE
shaadiya	FEMALE
shaady	MALE
shaakya	FEMALE
shaan	MALE
shabab	FEMALE
shabalini	FEMALE
shabana	FEMALE
shabar	MALE
shabari	FEMALE
shabeer-ali	MALE
shabnam	FEMALE
shabnum	FEMALE
shachi	FEMALE
shachin	MALE
shachindra	MALE
shadab	MALE
shadi	FEMALE
shafeeq	MALE
shafiq	MALE
shagufta	FEMALE
shagun	FEMALE
shahalad	MALE
shahana	FEMALE
shaheda	FEMALE
shaheen	FEMALE
shaheen	MALE
shaheena	FEMALE
shahid	MALE
shahnaaz	MALE
shahram	MALE
shahzad	MALE
shahzeela	FEMALE
shaila	FEMALE
shailaja	FEMALE
shailendra	MALE
shailesh	MALE
shailey	FEMALE
shaili	FEMALE
shailly	FEMALE
shaira	FEMALE
shaista	FEMALE
shaistakhan	MALE
shaiv	MALE
shaivi	FEMALE
shakambari	FEMALE
shakeel	FEMALE
shakeel	MALE
shakeela	FEMALE
shakib	MALE
shakini	FEMALE
shakti	FEMALE
shakti	MALE
shaktidhar	MALE
shakunt	MALE
shakuntala	FEMALE
shakyasinha	MALE
shalaka	FEMALE
shalakha	FEMALE
shalalu	FEMALE
shalang	MALE
shaligram	MALE
shalik	MALE
shalika	FEMALE
shalin	FEMALE
shalin	MALE
shalina	MALE
shaline	MALE
shalini	FEMALE
shalmali	FEMALE
shalmali	MALE
shalom	MALE
shama	FEMALE
shama	MALE
shamak	MALE
shamakarn	MALE
shambhavi	FEMALE
shambhu	MALE
shameek	MALE
shameem	FEMALE
shameena	FEMALE
shami	MALE
shamim	FEMALE
shamindra	MALE
shamini	FEMALE
shamir	MALE
shamita	FEMALE
shamitha	FEMALE
shamlee	FEMALE
shammy	FEMALE
shampa	FEMALE
shams	MALE
shamshu;	MALE
shamun	MALE
shandar	MALE
shania	FEMALE
shankar	MALE
shankari	FEMALE
shankarshan	MALE
shankdhar	MALE
shankha	MALE
shankhamala	FEMALE
shankhapani	MALE
shankhin	MALE
shankir	MALE
shanmitha	FEMALE
shanmuga	MALE
shanmukha	MALE
shansa	FEMALE
shanta	FEMALE
shantala	FEMALE
shantanav	MALE
shantanu	MALE
shantashil	MALE
shanti	FEMALE
shantidev	MALE
shantimay	MALE
shantinath	MALE
shantiprakash	MALE
shantipriya	MALE
shanyu	MALE
sharad	MALE
sharada	FEMALE
sharadchandra	MALE
sharadindu	MALE
sharadini	FEMALE
sharaku	MALE
sharan	MALE
sharang	MALE
sharanya	FEMALE
sharat	MALE
sharda	FEMALE
shardambha	FEMALE
shardul	MALE
shareef	MALE
shareefa	FEMALE
shari	FEMALE
sharika	FEMALE
sharini	FEMALE
shariq	MALE
sharjeel	MALE
sharleen	FEMALE
sharmila	FEMALE
sharmista	FEMALE
sharmistha	FEMALE
sharokh	MALE
sharol	FEMALE
sharu	MALE
sharvani	FEMALE
sharvari	FEMALE
shasha	FEMALE
shashank	MALE
shashanka	MALE
shashee	MALE
shashi	FEMALE
shashi	MALE
shashibala	FEMALE
shashibhushan	MALE
shashidhar	MALE
shashikant	MALE
shashikiran	MALE
shashimohan	MALE
shashin	MALE
shashini	FEMALE
shashirekha	FEMALE
shashish	MALE
shashishekhar	MALE
shashvat	MALE
shashwat	MALE
shaswati	FEMALE
shatakshi	FEMALE
shatarupa	FEMALE
shatha	FEMALE
shatrughan	MALE
shatrughna	MALE
shatrujit	MALE
shatrunjay	MALE
shattesh	MALE
shauchin	MALE
shaukat	MALE
shaul	MALE
shaunak	MALE
shaurav	MALE
shauri	MALE
shaurya	MALE
shawn	MALE
shazad	MALE
shazia	FEMALE
sheeba	FEMALE
sheece	MALE
sheela	FEMALE
sheelagh	FEMALE
sheetal	FEMALE
sheetal	MALE
shefali	FEMALE
shefalika	FEMALE
shehla	FEMALE
sheil	MALE
shejali	FEMALE
shekhar	FEMALE
shekhar	MALE
shekinah	MALE
shelly	FEMALE
shernaz	FEMALE
shesanand	MALE
shesh	MALE
shevalini	FEMALE
shevanti	FEMALE
shevantilal	MALE
shezreen	FEMALE
shiba	MALE
shibani	FEMALE
shibhya	MALE
shibu	MALE
shichi	FEMALE
shichiro	MALE
shichirobei	MALE
shielawatti	FEMALE
shiesta	FEMALE
shifa	FEMALE
shige	FEMALE
shigeaki	MALE
shigeharu	MALE
shigekazu	MALE
shigeki	MALE
shigeko	FEMALE
shigeko	MALE
shigemasa	MALE
shigematsu	MALE
shigemori	MALE
shigenaga	MALE
shigenobu	MALE
shigeo	MALE
shigeru	MALE
shigetaka	MALE
shigetoki	MALE
shigeyoshi	MALE
shigeyuki	MALE
shighra	MALE
shigochiyo	MALE
shih-fu	MALE
shihab	MALE
shihei	MALE
shihi	MALE
shiho	FEMALE
shijo	MALE
shika	FEMALE
shikha	FEMALE
shikha	MALE
shikhandin	MALE
shikhar	MALE
shiki	MALE
shiko	MALE
shila	FEMALE
shilang	MALE
shilavati(a	FEMALE
shilin	MALE
shilish	MALE
shilpa	FEMALE
shilpi	FEMALE
shilpita	FEMALE
shimei	MALE
shimon	MALE
shimpei	MALE
shin	MALE
shin'ichi	MALE
shin-ichiro	MALE
shin?ichi	MALE
shina	FEMALE
shineyu	MALE
shingen	MALE
shingo	MALE
shinichi	MALE
shinichiro	MALE
shinji	MALE
shinjini	FEMALE
shinju	FEMALE
shinkichi	MALE
shino	FEMALE
shino	MALE
shinobu	FEMALE
shinobu	MALE
shinrikiyaru	MALE
shinsaku	MALE
shinsui	MALE
shinsuke	MALE
shintaro	MALE
shinya	MALE
shinzaburo	MALE
shinzo	MALE
shioko	FEMALE
shiori	FEMALE
shipirist	MALE
shipra	FEMALE
shiraaz	FEMALE
shirai	MALE
shireen	FEMALE
shiri	FEMALE
shirin	FEMALE
shirina	FEMALE
shirish	MALE
shirley	FEMALE
shiro	MALE
shiromani	MALE
shirosama	MALE
shirshirchandra	MALE
shishir	MALE
shishirkana	FEMALE
shishirkumar	MALE
shishul	MALE
shishupal	MALE
shitikanth	MALE
shiuli	FEMALE
shiv	MALE
shivadev	MALE
shivaji	MALE
shivakanta	FEMALE
shivali	FEMALE
shivalik	MALE
shivam	MALE
shivanath	MALE
shivang	MALE
shivangi	FEMALE
shivani	FEMALE
shivanija	FEMALE
shivank	MALE
shivasunu	MALE
shivea	FEMALE
shiven	MALE
shivendra	MALE
shivendu	MALE
shivesh	MALE
shiveshvar	MALE
shivika	FEMALE
shivlal	MALE
shivohne	FEMALE
shivraj	MALE
shivram	MALE
shivshankar	MALE
shivta	FEMALE
shiwen	MALE
shizu	FEMALE
shizue	FEMALE
shizue	MALE
shizuka	FEMALE
shizuko	FEMALE
shlesh	MALE
shlokh	MALE
shlomo	MALE
sho	MALE
shobha	FEMALE
shobhan	MALE
shobhana	FEMALE
shobhita	FEMALE
shobhna	FEMALE
shoda	MALE
shogo	MALE
shohei	MALE
shohini	FEMALE
shoichi	MALE
shoin	MALE
shoji	MALE
shojiro	MALE
shoken	FEMALE
shoko	FEMALE
shoko	MALE
shoor	MALE
shoorsen	MALE
shoraku	MALE
shorashi	FEMALE
shosuke	MALE
shotaro	MALE
shou	MALE
shouko	FEMALE
shoumo	FEMALE
shouta	MALE
shoyo	MALE
shozaburo	MALE
shozo	MALE
shrabana	FEMALE
shraddha	FEMALE
shradhdha	FEMALE
shramidhi	FEMALE
shravan	MALE
shravana	FEMALE
shravani	FEMALE
shravankumar	MALE
shravanti	FEMALE
shravasti	FEMALE
shravya	FEMALE
shrawantika	FEMALE
shree	FEMALE
shreela	FEMALE
shreema	FEMALE
shreemayi	FEMALE
shreeparna	FEMALE
shrenik	MALE
shreshta	MALE
shresta	FEMALE
shrestajna	MALE
shresth	FEMALE
shresth	MALE
shresthi	FEMALE
shresthi	MALE
shrey	MALE
shreya	FEMALE
shreyas	MALE
shreyashi	FEMALE
shreyasi	FEMALE
shri	FEMALE
shrida	MALE
shridevi	FEMALE
shridhar	MALE
shridula	FEMALE
shridulla	FEMALE
shrigauri	FEMALE
shrigeeta	FEMALE
shrigopal	MALE
shrihan	MALE
shrihari	MALE
shrijani	FEMALE
shrika	FEMALE
shrikala	FEMALE
shrikama	FEMALE
shrikant	MALE
shrikanta	MALE
shrikanth	MALE
shrikar	MALE
shrikeshav	MALE
shrikirti	FEMALE
shrikrishna	MALE
shrikumar	MALE
shrikumari	FEMALE
shrila	FEMALE
shrilata	FEMALE
shrilaxmi	FEMALE
shrilekha	FEMALE
shrimat	MALE
shrimati	FEMALE
shrimayi	FEMALE
shrimohan	MALE
shrina	FEMALE
shrinand	MALE
shrinath	MALE
shringesh	MALE
shriniketan	MALE
shrinivas	MALE
shripad	MALE
shripadma	MALE
shripal	MALE
shripati	MALE
shriram	MALE
shrirang	MALE
shriranga	MALE
shriranjan	MALE
shrish	MALE
shrisha	MALE
shristhi	FEMALE
shrivali	FEMALE
shrivalli	FEMALE
shrivarah	MALE
shrivardhan	MALE
shrivas	MALE
shrivatsa	MALE
shrividya	FEMALE
shriya	FEMALE
shriyadita	FEMALE
shriyans	MALE
shrusti	FEMALE
shruti	FEMALE
shu-hwa	FEMALE
shubendra	MALE
shubh	MALE
shubha	FEMALE
shubha	MALE
shubhada	FEMALE
shubhaksh	MALE
shubhang	MALE
shubhangi	FEMALE
shubhankar	MALE
shubhashis	MALE
shubhay	MALE
shubhendu	MALE
shubhi	FEMALE
shubhojit	MALE
shubhra	FEMALE
shubhranshu	MALE
shubhrita	FEMALE
shuchi	FEMALE
shuchismita	FEMALE
shuchita	FEMALE
shuddhashil	MALE
shuddhi	FEMALE
shuhei	MALE
shuichi	MALE
shuji	MALE
shukishi	MALE
shukla	FEMALE
shukla	MALE
shuko	MALE
shukti	FEMALE
shulabh	MALE
shulandhar	MALE
shulin	MALE
shulini	FEMALE
shulka	FEMALE
shuly	FEMALE
shumei	MALE
shumkichi	MALE
shun	FEMALE
shun	MALE
shuna	MALE
shuncho	MALE
shungyosai	MALE
shunichi	MALE
shunji	MALE
shunko	MALE
shunmyo	MALE
shunsen	MALE
shunsho	MALE
shunso	MALE
shunsuke	MALE
shunta	FEMALE
shuntaro	MALE
shun’en	MALE
shusake	MALE
shusaku	MALE
shushil	MALE
shushma	FEMALE
shusui	MALE
shutradevi	FEMALE
shuya	MALE
shuzo	MALE
shvant	MALE
shveni	FEMALE
shveta	FEMALE
shvetambar	MALE
shvetang	MALE
shvetank	MALE
shvetanshu	MALE
shvetavah	MALE
shweeta	FEMALE
shweta	FEMALE
shwetha	FEMALE
shwiti	FEMALE
shyam	MALE
shyama	FEMALE
shyamak	MALE
shyamal	FEMALE
shyamal	MALE
shyamala	FEMALE
shyamali	FEMALE
shyamalika	FEMALE
shyamalima	FEMALE
shyamangi	FEMALE
shyamantak	MALE
shyamari	FEMALE
shyamasri	FEMALE
shyamlata	FEMALE
shyamsundar	MALE
shyamsunder	MALE
shyla	FEMALE
shyma	FEMALE
sibani	FEMALE
sibel	FEMALE
sibylle	FEMALE
siddartha	MALE
siddha	MALE
siddhadev	MALE
siddhama	FEMALE
siddhangana	FEMALE
siddhani	FEMALE
siddhanta	MALE
siddhanth	MALE
siddharth	MALE
siddhartha	MALE
siddhesh	MALE
siddheshwar	MALE
siddheshwari	FEMALE
siddhi	FEMALE
siddhima	FEMALE
siddhraj	MALE
siddid	MALE
siegfried	MALE
sihaam	FEMALE
siham	FEMALE
sikata	FEMALE
sikta	FEMALE
silja	FEMALE
silke	FEMALE
silvan	MALE
silvie	FEMALE
silviu	MALE
simbala	FEMALE
simi	FEMALE
simonetta	FEMALE
simran	FEMALE
simrit	FEMALE
sin-jae	MALE
sinaporn	FEMALE
sindhu	FEMALE
sindhu	MALE
sindhuja	FEMALE
sindhunath	MALE
sinha	MALE
sinhag	MALE
sinhayana	FEMALE
sinhvahan	MALE
sinjeet	MALE
sinjini	FEMALE
sinsapa	FEMALE
sinwon	MALE
siona	FEMALE
siraaj	MALE
siraj	MALE
siri	FEMALE
sisay	MALE
sita	FEMALE
sitakanta	MALE
sitanshu	MALE
sitara	FEMALE
sitesh	FEMALE
sitikantha	MALE
sivaji	MALE
sivanantham	MALE
sivanta	MALE
siya	FEMALE
skanda	FEMALE
skandajit	FEMALE
slav	MALE
slava	MALE
slaven	MALE
slobodan	MALE
smarajit	MALE
smaram	FEMALE
smaran	MALE
smaranda	FEMALE
smera	FEMALE
smita	FEMALE
smith	MALE
smitha	FEMALE
smrita	FEMALE
smriti	FEMALE
smritiman	MALE
smruti	FEMALE
sneh	FEMALE
sneha	FEMALE
snehakant	MALE
snehal	FEMALE
snehal	MALE
snehalata	FEMALE
snehanshn	MALE
snehin	MALE
snigda	FEMALE
snigdha	FEMALE
so-young	FEMALE
sobaika	FEMALE
sobha	FEMALE
soetsu	MALE
sofia	FEMALE
sofie	FEMALE
sofu	MALE
soh	MALE
sohail	MALE
sohalia	FEMALE
soham	MALE
sohan	MALE
sohil	MALE
sohni	FEMALE
soichiro	MALE
sojuro	MALE
som	MALE
soma	FEMALE
somadev	MALE
somalakshmi	FEMALE
somali	MALE
soman	MALE
somansh	FEMALE
somansh	MALE
somanshu	MALE
somashekhar	MALE
somasindhu	MALE
somatra	FEMALE
somayajulu	MALE
somendra	MALE
somesh	MALE
someshwar	MALE
somila	FEMALE
somnath	MALE
sona	FEMALE
sonakshi	FEMALE
sonal	FEMALE
sonali	FEMALE
songsak	MALE
songwook	MALE
sonia	FEMALE
sonika	FEMALE
sonita	FEMALE
sonjia	FEMALE
soo-hong	MALE
soo-min	FEMALE
soojong	MALE
soorat	FEMALE
sopan	MALE
sorai	MALE
soren	MALE
sosa	MALE
soseki	MALE
soshitsu	MALE
soshu	MALE
sosuke	MALE
sotan	MALE
sotaro	MALE
sotatsu	MALE
soumen	MALE
soumil	MALE
soumya	FEMALE
soumyakanti	MALE
soumyata	FEMALE
sourabh	MALE
sourabhi	FEMALE
sourish	MALE
souta	MALE
sowjanya	FEMALE
sowmiya	FEMALE
sozen	MALE
sozui	MALE
spandana	FEMALE
spoorti	FEMALE
sprihi	FEMALE
spyridoula	FEMALE
spyros	MALE
sravan	MALE
sravana	FEMALE
sravani	FEMALE
sravya	FEMALE
sreedevi	FEMALE
sreenesh	MALE
sreeparna	FEMALE
sreeram	MALE
sri	MALE
sridatta	MALE
sridevi	FEMALE
sridhar	MALE
sriharsha	FEMALE
srijan	MALE
srijani	FEMALE
srikant	MALE
srikanth	MALE
srilatha	FEMALE
srinivas	MALE
srinivasa	MALE
srinivasan	MALE
sriram	MALE
srirupa	FEMALE
sristi	FEMALE
sriya	FEMALE
sruthi	FEMALE
ssekien	MALE
st?phane	MALE
st?phanie	FEMALE
staffan	MALE
stanislao	MALE
stanislas	MALE
stanislaw	MALE
stanko	MALE
stanley	MALE
stasinos	MALE
stavita	FEMALE
stavros	MALE
stefano	MALE
steffan	FEMALE
steffen	MALE
stephan-ylan	MALE
stergos	MALE
stevan	MALE
sthavir	MALE
sthir	MALE
stig	MALE
stijn	MALE
stimit	MALE
stina	FEMALE
stotri	MALE
stoyan	MALE
striratna	FEMALE
stuti	FEMALE
su-youn	FEMALE
sual	MALE
subal	MALE
subali	MALE
subarna	FEMALE
subaru	MALE
subash	MALE
subbarao	MALE
subeer	MALE
subhadra	FEMALE
subhadra	MALE
subhaga	FEMALE
subhagya	FEMALE
subhan	MALE
subhang	MALE
subhash	MALE
subhashini	FEMALE
subhasini	FEMALE
subhi	FEMALE
subhiksha	FEMALE
subhuja	FEMALE
subhy	MALE
subinay	MALE
subodh	MALE
subrata	FEMALE
subrata	MALE
subrina	FEMALE
suchandra	FEMALE
sucharita	FEMALE
suchendra	MALE
suchet	MALE
sucheta	FEMALE
suchhaya	FEMALE
suchi	FEMALE
suchinder	MALE
suchir	MALE
suchira	FEMALE
suchita	FEMALE
suchitra	FEMALE
sudakshima	FEMALE
sudama	MALE
sudarshan	MALE
sudarshana	FEMALE
sudarshini	FEMALE
suday	MALE
sudeep	MALE
sudeepa	FEMALE
sudeepta	FEMALE
sudesh	MALE
sudesha	MALE
sudeshna	FEMALE
sudeva	MALE
sudevi	FEMALE
sudha	FEMALE
sudhakar	MALE
sudhamay	MALE
sudhamayi	FEMALE
sudhang	MALE
sudhanshu	MALE
sudhanssu	MALE
sudhanvan	MALE
sudhendra	MALE
sudhi	MALE
sudhindra	MALE
sudhir	MALE
sudhira	FEMALE
sudhish	MALE
sudhit	MALE
sudiksha	FEMALE
sudip	MALE
sudipta	FEMALE
sudipti	FEMALE
sudir	MALE
sueharu	MALE
suezo	MALE
sugandha	FEMALE
sugata	MALE
sugauri	FEMALE
suggi	FEMALE
sugimoto	MALE
sugita	FEMALE
sugita	MALE
sugouri	FEMALE
sugreev	MALE
sugriva	MALE
suguru	MALE
suha	FEMALE
suhag	FEMALE
suhagi	FEMALE
suhail	MALE
suhaila	FEMALE
suhair	FEMALE
suhana	FEMALE
suhanya	FEMALE
suhas	FEMALE
suhas	MALE
suhasini	FEMALE
suhayb	MALE
suhayla	FEMALE
suhayma	FEMALE
suhina	FEMALE
suhrid	MALE
suhrit	MALE
suhrita	FEMALE
sui	FEMALE
sujal	MALE
sujala	FEMALE
sujan	MALE
sujash	MALE
sujata	FEMALE
sujatha	FEMALE
sujay	MALE
sujaya	FEMALE
sujetu	MALE
sujit	MALE
sujith	MALE
suka	MALE
sukant	MALE
sukanta	MALE
sukanya	FEMALE
sukejuro	MALE
sukenobu	MALE
sukesh	MALE
sukeshi	FEMALE
suketsune	MALE
suketu	MALE
sukey	FEMALE
sukeyasu	MALE
sukhajat	MALE
sukhakar	MALE
sukhamay	MALE
sukhashakt	MALE
sukhdev	MALE
sukhen	MALE
sukhesh	MALE
suki	FEMALE
sukirti	FEMALE
suko	FEMALE
sukrit	FEMALE
sukrit	MALE
sukriti	FEMALE
suksha	FEMALE
suksma	FEMALE
sukumar	MALE
sukumari	FEMALE
sukushi	FEMALE
sulabha	FEMALE
sulaksha	FEMALE
sulakshana	FEMALE
sulakshmi	FEMALE
sulalit	MALE
sulalita	FEMALE
sulayman	MALE
sulbha	FEMALE
sulek	MALE
sulekh	FEMALE
sulekh	MALE
suloch	FEMALE
sulochan	MALE
sulochana	FEMALE
sulochna	MALE
sultan	MALE
sultana	FEMALE
suma	FEMALE
sumaiyaa	FEMALE
sumali	FEMALE
suman	FEMALE
suman	MALE
sumana	FEMALE
sumangli	FEMALE
sumanolata	FEMALE
sumant	MALE
sumanta	MALE
sumanth	MALE
sumantra	MALE
sumati	FEMALE
sumatinath	MALE
sumavali	FEMALE
sumay	MALE
sumed	MALE
sumedha	FEMALE
sumeer	MALE
sumeesh	MALE
sumeet	MALE
sumeru	MALE
sumi	FEMALE
sumie	FEMALE
sumiko	FEMALE
sumio	MALE
sumire	FEMALE
sumit	MALE
sumita	FEMALE
sumiteru	MALE
sumithra	FEMALE
sumitomo	MALE
sumitra	FEMALE
sumitra	MALE
sumiyo	FEMALE
sumona	FEMALE
sumukh	MALE
sumukhi	FEMALE
sun-hee	FEMALE
sun-mee	FEMALE
sunaina	FEMALE
sunanda	FEMALE
sunanda	MALE
sunandini	FEMALE
sunandita	FEMALE
sunar	MALE
sunashi	MALE
sunasi	MALE
sunay	MALE
sunayana	FEMALE
sunayani	FEMALE
sunayna	FEMALE
sundar	MALE
sundaravathana	MALE
sundari	FEMALE
sunder	MALE
sundesh	MALE
sundha	FEMALE
suneet	MALE
suneeti	FEMALE
sunetra	FEMALE
sung-jin	MALE
sung-kwon	MALE
sunghoon	MALE
sunil	MALE
sunila	FEMALE
sunirmal	MALE
sunita	FEMALE
suniti	FEMALE
sunjeev	MALE
suoud	MALE
suparn	MALE
suparna	FEMALE
suparna	MALE
supash	MALE
suphanut	MALE
suprabha	FEMALE
suprakash	MALE
supratik	MALE
supratim	MALE
suprema	FEMALE
suprit	FEMALE
supriti	FEMALE
supriya	FEMALE
supriya	MALE
sur	MALE
surabhi	FEMALE
suradhish	MALE
suradip	MALE
suragan	MALE
suraj	MALE
surajit	MALE
surajiv	MALE
suraksha	FEMALE
suram	MALE
surama	FEMALE
suran	MALE
surangi	FEMALE
suranjan	MALE
suranjana	FEMALE
surarihan	MALE
surasa	FEMALE
suravi	FEMALE
suravinda	FEMALE
surbhi	FEMALE
surbhup	MALE
surdeep	MALE
surekha	FEMALE
suren	MALE
surendra	MALE
surendran	MALE
suresh	MALE
sureshi	FEMALE
suri	MALE
surina	FEMALE
surotama	FEMALE
suruchi	FEMALE
surup	MALE
surupa	FEMALE
surush	MALE
surya	MALE
suryabhan	MALE
suryadev	MALE
suryadita	FEMALE
suryakant	MALE
suryakanta	MALE
suryakanti	FEMALE
suryanarayanan	MALE
suryani	FEMALE
suryanshu	MALE
suryashankar	MALE
suryesh	MALE
susadh	MALE
susen	MALE
sushama	FEMALE
sushant	MALE
sushanta	MALE
sushanti	FEMALE
susher	MALE
sushil	MALE
sushila	FEMALE
sushim	MALE
sushma	FEMALE
sushmita	FEMALE
sushmitha	FEMALE
sushobhan	MALE
sushobhana	FEMALE
sushrut	MALE
sushruta	MALE
susita	FEMALE
susmita	FEMALE
susumu	MALE
sutantu	MALE
sutanuka	FEMALE
sutapa	FEMALE
sutara	FEMALE
sutej	MALE
sutirth	MALE
sutoya	MALE
suvali	FEMALE
suvan	MALE
suvankar	MALE
suvarn	MALE
suvarna	FEMALE
suvarnaprabha	FEMALE
suvarnarekha	FEMALE
suvarnmala	FEMALE
suvas	MALE
suvel	MALE
suvidh	MALE
suvimal	MALE
suvina	FEMALE
suvir	MALE
suvit	MALE
suvrata	MALE
suyamun	MALE
suyash	MALE
suyati	MALE
suzannah	FEMALE
suzu	FEMALE
suzu	MALE
suzue	FEMALE
suzuki	FEMALE
suzuko	FEMALE
suzume	FEMALE
svadhi	FEMALE
svaha	FEMALE
svamin	MALE
svaminath	MALE
svana	FEMALE
svang	MALE
svanik	MALE
svar	MALE
svara	FEMALE
svaraj	MALE
svarg	MALE
svarna	MALE
svarpati	MALE
svayambhu	MALE
svayambhut	MALE
sven	MALE
svenja	FEMALE
svetla	FEMALE
svetlana	FEMALE
svetoslav	MALE
sveva	FEMALE
svitlana	FEMALE
svitra	FEMALE
svjatoslav	MALE
swagat	MALE
swagata	FEMALE
swaha	FEMALE
swami	MALE
swaminath	MALE
swapan	MALE
swapna	FEMALE
swapnali	FEMALE
swapnasundari	FEMALE
swapnil	MALE
swaraj	MALE
swarit	MALE
swarna	FEMALE
swarnalata	FEMALE
swarup	MALE
swarupa	FEMALE
swasti	FEMALE
swastik	MALE
swathi	FEMALE
swati	FEMALE
swayam	MALE
swayambhu	MALE
sweta	FEMALE
swetaketu	MALE
syamantak	MALE
syed	MALE
sylvain	MALE
sylvaine	FEMALE
sylvana	FEMALE
sylviane	FEMALE
sylvie	FEMALE
sylwia	FEMALE
syon	MALE
syrus	MALE
syum	MALE
syun	MALE
szuting	FEMALE
taahir	MALE
taahira	FEMALE
taamir	MALE
tabassum	FEMALE
tabito	MALE
tabreesha	FEMALE
tadaaki	MALE
tadahisa	MALE
tadako	FEMALE
tadakuni	MALE
tadamasa	MALE
tadamichi	MALE
tadanobu	MALE
tadao	MALE
tadashi	MALE
tadasu	MALE
tadasuke	MALE
tadataka	MALE
tadayoshi	MALE
tadayuki	MALE
tadesse	MALE
tadiyuki	MALE
tae	FEMALE
tae-yeoub	MALE
taejin	MALE
taesun	MALE
taewan	MALE
taheiji	MALE
tahir	MALE
tai	FEMALE
taichi	MALE
taiichi	MALE
taijiro	MALE
taikan	MALE
taiki	MALE
taiko	FEMALE
taisho	MALE
taisuke	MALE
taizeen	MALE
taj	FEMALE
taj	MALE
tajdar	MALE
taji	FEMALE
taji	MALE
taka	FEMALE
takaaki	MALE
takafumi	MALE
takahashi	MALE
takahiko	MALE
takahiro	MALE
takahisa	MALE
takakazu	MALE
takaki	MALE
takako	FEMALE
takamasa	MALE
takamori	MALE
takamuku	MALE
takanibu	MALE
takano	FEMALE
takanobu	MALE
takanori	MALE
takao	MALE
takara	FEMALE
takashi	MALE
takauji	MALE
takayuki	MALE
takeaki	MALE
takechi	MALE
takefumi	MALE
takehide	MALE
takehiko	MALE
takehiro	MALE
takehito	MALE
takeichi	MALE
takeji	MALE
takejiro	MALE
takenao	MALE
takenobu	MALE
takeo	MALE
takeru	MALE
takeshi	MALE
takesi	MALE
takeyuki	MALE
taki	MALE
takiji	MALE
taksha	MALE
taksheel	MALE
taku	MALE
takuboku	MALE
takuji	MALE
takuma	MALE
takumi	MALE
takuro	MALE
takushi	MALE
takuya	MALE
talaketu	MALE
talal	MALE
talank	MALE
talat	MALE
talha	MALE
talib	MALE
talika	FEMALE
talin	MALE
talish	MALE
talleen	MALE
talli	FEMALE
talya	FEMALE
tama	FEMALE
tamadhur	FEMALE
tamae	FEMALE
tamafune	FEMALE
tamaki	FEMALE
tamal	MALE
tamali	FEMALE
tamalika	FEMALE
tamam	MALE
tamami	FEMALE
tamanna	FEMALE
tamas	MALE
tamasa	FEMALE
tamasaburo	MALE
tamasi	FEMALE
tamasine	MALE
tambura	FEMALE
tameyoshi	MALE
tami	FEMALE
tamika	FEMALE
tamiko	FEMALE
tamiyo	FEMALE
tamkinat	MALE
tamoghna	MALE
tamonash	MALE
tamotsu	MALE
tamura	FEMALE
tamura	MALE
tamuramaro	MALE
tana	MALE
tanak	FEMALE
tanak	MALE
tanav	MALE
tanay	MALE
tanaya	FEMALE
tanel	MALE
tango	MALE
tanika	FEMALE
taniko	FEMALE
tanima	FEMALE
tanirika	FEMALE
tanish	MALE
tanisha	FEMALE
tanisi	FEMALE
tanjiro	MALE
tanmay	MALE
tanmaya	FEMALE
tanmayee	FEMALE
tanmayi	FEMALE
tanmoy	MALE
tannishtha	FEMALE
tanoj	MALE
tanosuke	MALE
tanseem	FEMALE
tansho	FEMALE
tansi	FEMALE
tanu	FEMALE
tanuj	MALE
tanuja	FEMALE
tanuka	FEMALE
tanushri	FEMALE
tanveer	MALE
tanvi	FEMALE
tanvir	MALE
tanya	FEMALE
tanyu	MALE
tanzan	MALE
tapan	MALE
tapani	FEMALE
tapas	MALE
tapasendra	MALE
tapasi	FEMALE
tapasranjan	MALE
tapasya	FEMALE
tapati	FEMALE
tapesh	MALE
tapeshwar	MALE
tapi	FEMALE
tapio	MALE
tapomay	MALE
tapti	FEMALE
tara	FEMALE
tarachand	MALE
taradhish	MALE
tarai	FEMALE
tarak	MALE
taraka	FEMALE
tarakeshwar	MALE
tarakeshwari	FEMALE
tarakini	FEMALE
taraknath	MALE
taraksh	MALE
taral	MALE
tarala	FEMALE
taran	MALE
tarana	FEMALE
tarang	MALE
taranga	MALE
tarangini	FEMALE
tarani	FEMALE
tarannum	FEMALE
taraprashad	MALE
taree	FEMALE
tareef	MALE
tarendra	MALE
tarfah	MALE
tarik	MALE
tarika	FEMALE
tarini	FEMALE
tariq	MALE
tarit	MALE
tarita	FEMALE
tarjani	FEMALE
tarjni	FEMALE
tarla	FEMALE
tarli	FEMALE
tarlika	FEMALE
taro	MALE
taroemon	MALE
taroob	FEMALE
tarozaemon	MALE
taru	FEMALE
taru	MALE
tarulata	FEMALE
tarun	MALE
taruna	FEMALE
taruni	FEMALE
tarunika	FEMALE
tarunima	FEMALE
taruntapan	MALE
tashiaki	MALE
tashiro	MALE
tasneem	FEMALE
tasuku	MALE
tateshi	MALE
tathagat	MALE
tathagata	MALE
tatini	FEMALE
tatsuhiko	MALE
tatsui	MALE
tatsukichi	MALE
tatsuo	MALE
tatsuya	MALE
tatsuzo	MALE
tatya	MALE
tauheed	FEMALE
tauheed	MALE
taura	FEMALE
tausiq	MALE
tautik	MALE
tavisha	FEMALE
tavishi	FEMALE
tawfeeq	MALE
taya	FEMALE
taymullah	MALE
tayseer	MALE
taysuke	MALE
teemu	MALE
teerth	MALE
teertha	FEMALE
teerthankar	MALE
teesta	FEMALE
tehzeeb	FEMALE
teigo	MALE
teiji	MALE
teijo	MALE
teika	MALE
teiljo	MALE
teinosuke	MALE
tej	MALE
teja	FEMALE
tejal	FEMALE
tejas	MALE
tejasvi	FEMALE
tejaswi	FEMALE
tejaswini	FEMALE
tejendra	MALE
tejeshwar	MALE
tejomay	MALE
tekkan	MALE
tenshin	MALE
terao	MALE
tereshan	MALE
teriuihi	MALE
terry	MALE
teruaki	MALE
teruka	FEMALE
teruko	FEMALE
terumoto	MALE
teruo	MALE
teruyo	FEMALE
teruyoshi	MALE
tessai	MALE
teta	FEMALE
tetsu	MALE
tetsuhiko	MALE
tetsui	MALE
tetsuji	MALE
tetsunori	MALE
tetsunosuke	MALE
tetsuo	MALE
tetsuro	MALE
tetsushi	MALE
tetsuya	MALE
tetsuyuki	MALE
tetsuzan	MALE
thaabit	MALE
thakur	MALE
thamar	FEMALE
thanaa	FEMALE
thanmayee	FEMALE
thaqib	MALE
tharaa	FEMALE
tharanum	FEMALE
thatsanee	FEMALE
thavanesh	MALE
theodoros	MALE
thepchai	MALE
thiago	MALE
thierry	MALE
thilo	MALE
thoki	MALE
thorstein	MALE
thorsten	MALE
thumri	FEMALE
thuraya	FEMALE
thwishaa	FEMALE
tiago	MALE
tianfang	MALE
tibor	MALE
tiejun	MALE
tiit	MALE
tijl	MALE
tilak	MALE
tilaka	FEMALE
tilika	FEMALE
tilman	MALE
tilottama	FEMALE
timila	FEMALE
timin	MALE
timir	MALE
timirbaran	MALE
timm	MALE
timo	MALE
timotius	MALE
timur	MALE
tina	FEMALE
tiphaine	FEMALE
tirishaanth	MALE
tirranand	MALE
tirth	MALE
tirtha	MALE
tirthankar	MALE
tirthayaad	MALE
tisha	FEMALE
tisya	FEMALE
tisyaketu	MALE
titiksha	FEMALE
titir	MALE
tiya	FEMALE
tobei	MALE
todor	MALE
togai	MALE
tohaku	MALE
tohru	MALE
toichi	MALE
toin	MALE
toine	MALE
toju	MALE
tokaji	MALE
toki	FEMALE
toki	MALE
tokichiro	MALE
tokie	FEMALE
tokiko	FEMALE
tokimasa	MALE
tokimune	MALE
tokiyo	FEMALE
toku	FEMALE
tokugawa	MALE
tokuhei	MALE
tokuma	MALE
tokutomi	MALE
toma??	MALE
tomanek	MALE
tomasz	MALE
tomaz	MALE
tomek	MALE
tomeo	MALE
tomi	FEMALE
tomiichi	MALE
tomiji	MALE
tomika-shea	FEMALE
tomiko	FEMALE
tomio	MALE
tommaso	MALE
tommi	MALE
tomoaki	MALE
tomoe	FEMALE
tomohiko	MALE
tomohiro	MALE
tomokazu	MALE
tomoko	FEMALE
tomomi	FEMALE
tomomi	MALE
tomoya	MALE
tomoyoshi	MALE
tomoyosi	MALE
tomoyuki	MALE
ton	MALE
tonde-csilla	FEMALE
tonto	MALE
tony	MALE
tor	MALE
torajiro	MALE
toral	FEMALE
torazo	MALE
torbj?rn	MALE
torbjorn	MALE
tore	MALE
torio	MALE
torsten	MALE
toru	MALE
torvald	MALE
toshan	MALE
toshani	FEMALE
toshi	FEMALE
toshi	MALE
toshiaki	MALE
toshie	FEMALE
toshifumi	MALE
toshiharu	MALE
toshihiko	MALE
toshihiro	MALE
toshihisa	MALE
toshikasu	MALE
toshikazu	MALE
toshiki	MALE
toshiko	FEMALE
toshikuni	MALE
toshimichi	MALE
toshinobu	MALE
toshio	MALE
toshiro	MALE
toshitsugu	MALE
toshiyuki	MALE
tosiyasu	MALE
toson	MALE
totoya	MALE
toya	FEMALE
toyesh	MALE
toyoaki	MALE
toyoharu	MALE
toyokazu	MALE
toyoko	FEMALE
toyokuni	MALE
toyomi	FEMALE
toyonobu	MALE
toyoshige	MALE
toyotomi	MALE
toyozo	MALE
trailokva	MALE
trambak	MALE
trayi	FEMALE
triambak	MALE
triambika	FEMALE
tribhuvan	MALE
tridhaman	MALE
tridhara	FEMALE
tridhatri	MALE
tridib	MALE
tridiva	FEMALE
trigun	MALE
triguna	FEMALE
triguni	FEMALE
trigya	MALE
trijagati	FEMALE
trijal	MALE
trikay	MALE
trikaya	FEMALE
trilochan	MALE
trilochana	FEMALE
trilok	MALE
trilokanath	MALE
trilokesh	MALE
triman	MALE
trimurti	MALE
trinabh	MALE
trinayan	MALE
trinayani	FEMALE
trinetra	FEMALE
trinity	FEMALE
triparna	FEMALE
tripta	FEMALE
tripti	FEMALE
tripura	FEMALE
tripurajit	MALE
tripurari	MALE
tripurasundari	FEMALE
tripuri	FEMALE
triputa	FEMALE
trisha	FEMALE
trishala	FEMALE
trishanku	MALE
trishar	MALE
trishna	FEMALE
trishul	MALE
trishulank	MALE
trishulin	MALE
trishulini	FEMALE
tristan	MALE
triti	FEMALE
triveni	FEMALE
trivikram	MALE
triya	FEMALE
triyama	FEMALE
trond	MALE
trude	FEMALE
trung	MALE
trupti	FEMALE
trusha	FEMALE
tsubaki	FEMALE
tsubame	FEMALE
tsugahara	MALE
tsugiharu	MALE
tsuginori	MALE
tsugumichi	MALE
tsukasa	MALE
tsuki	FEMALE
tsukiko	FEMALE
tsukiyama	FEMALE
tsumemasa	MALE
tsunao	MALE
tsunayoshi	MALE
tsuneaki	MALE
tsuneari	MALE
tsunehisa	MALE
tsuneko	FEMALE
tsunenori	MALE
tsuneo	MALE
tsunesaburo	MALE
tsuneyo	MALE
tsuramatsu	MALE
tsurayaki	MALE
tsuruki	MALE
tsutomu	MALE
tsuya	FEMALE
tsuyoshi	MALE
tufan	MALE
tugba	FEMALE
tuhi	FEMALE
tuhin	MALE
tuhina	FEMALE
tuhinsurra	MALE
tuka	MALE
tukaram	MALE
tulasi	FEMALE
tulasidas	MALE
tulika	FEMALE
tulsi	FEMALE
tulsidas	MALE
tulya	FEMALE
tunda	MALE
tunde	MALE
tuneo	MALE
tunganath	MALE
tungar	MALE
tungesh	MALE
tungeshwar	MALE
tungish	MALE
tuomo	MALE
tuomu	MALE
turag	MALE
turanya	FEMALE
turvi	FEMALE
turya	FEMALE
tushar	MALE
tusharkana	FEMALE
tusharkanti	MALE
tusharsuvra	MALE
tushita	FEMALE
tusti	FEMALE
tusya	MALE
tuvidyumna	MALE
tuvijat	MALE
tvarita	FEMALE
tvisha	FEMALE
tvishi	FEMALE
tyagraja	MALE
tyne	FEMALE
ubaadah	MALE
ubaidah	MALE
ubay	MALE
ubika	FEMALE
ucchal	FEMALE
uchadev	MALE
uchit	MALE
udant	MALE
udantika	FEMALE
udar	MALE
udarathi	MALE
udarchis	MALE
udarsh	MALE
uday	MALE
udaya	FEMALE
udayachal	MALE
udayan	MALE
udbal	MALE
uddhar	MALE
uddhav	MALE
uddip	MALE
uddiran	MALE
uddish	MALE
uddiyan	MALE
uddunath	MALE
udeep	MALE
udgita	FEMALE
udipti	FEMALE
udit	MALE
udita	FEMALE
uditi	FEMALE
udo	MALE
udu	MALE
udupati	MALE
uduraj	MALE
udyam	MALE
udyan	MALE
udyati	FEMALE
ugresh	MALE
ujagar	MALE
ujala	MALE
ujas	FEMALE
ujas	MALE
ujendra	MALE
ujesh	MALE
ujjala	FEMALE
ujjanini	FEMALE
ujjay	MALE
ujjwal	MALE
ujjwala	FEMALE
ujval	MALE
ujvala	FEMALE
ujwal	MALE
ujwala	FEMALE
ukon	MALE
ukyo	MALE
ulf	MALE
ulhas	MALE
ulka	FEMALE
ulla	FEMALE
ullas	MALE
ullupi	FEMALE
ulmuk	MALE
ulrich	MALE
ulrike	FEMALE
ulupi	FEMALE
ulupya	FEMALE
uma	FEMALE
umaarah	MALE
umair	MALE
umakant	MALE
umanand	MALE
umanant	MALE
umang	MALE
umaprasad	MALE
umar	MALE
umashankar	MALE
ume	FEMALE
umed	MALE
umeka	FEMALE
umeko	FEMALE
umesh	MALE
umeshwar	MALE
umika	FEMALE
umrao	FEMALE
umrao	MALE
undine	FEMALE
unjali	FEMALE
unkei	MALE
unma	FEMALE
unmesh	MALE
unnabh	MALE
unnat	MALE
unnati	FEMALE
unnatish	MALE
unni	FEMALE
unnikrishnan	MALE
upadhriti	FEMALE
upagupta	MALE
upala	FEMALE
upama	FEMALE
upamanyu	MALE
upasana	FEMALE
upasna	FEMALE
upendra	MALE
upkar	FEMALE
upma	FEMALE
uppas	MALE
uqbah	MALE
ura	FEMALE
urako	FEMALE
urav	MALE
uri	MALE
urishilla	FEMALE
urishita	FEMALE
urja	FEMALE
urjani	MALE
urjita	FEMALE
urjita	MALE
urmi	FEMALE
urmika	FEMALE
urmil	FEMALE
urmila	FEMALE
urmimala	FEMALE
urmiya	MALE
urna	FEMALE
urshita	FEMALE
ursula	FEMALE
urugay	MALE
urvang	MALE
urvashi	FEMALE
urvasi	FEMALE
urvi	FEMALE
urvish	MALE
usaamah	MALE
usagi	FEMALE
usha	FEMALE
ushakanta	MALE
ushakiran	FEMALE
ushangu	MALE
usharvi	FEMALE
ushashi	FEMALE
ushi	FEMALE
ushma	FEMALE
ushnisin	MALE
usra	FEMALE
usri	FEMALE
uta	FEMALE
utaemon	MALE
utako	FEMALE
utalika	FEMALE
utamara	MALE
utamuro	MALE
utanka	MALE
utbah	MALE
ute	FEMALE
utemaro	MALE
utkarsh	MALE
utkarsha	FEMALE
utkarsha	MALE
utpal	MALE
utpala	FEMALE
utpalaksh	MALE
utpalakshi	FEMALE
utpalini	FEMALE
utsa	FEMALE
utsav	MALE
uttam	MALE
uttamesh	MALE
uttar	MALE
uttara	FEMALE
uttarak	MALE
uttiya	MALE
uwe	MALE
uzair	MALE
uzuoka	MALE
v?clav	MALE
v?ronique	FEMALE
vaagdevi	FEMALE
vachan	MALE
vachaspati	MALE
vaclav	MALE
vadish	MALE
vagdevi	FEMALE
vagindra	MALE
vagish	MALE
vagishwari	FEMALE
vahin	MALE
vahini	FEMALE
vaibhav	MALE
vaibhavi	FEMALE
vaidarbhi	FEMALE
vaidehi	FEMALE
vaijayanti	FEMALE
vaijayantimala	FEMALE
vaijayi	MALE
vaijnath	MALE
vaikartan	MALE
vaikhan	MALE
vaikunth	MALE
vainavi	FEMALE
vainavin	MALE
vairaj	MALE
vairat	MALE
vairinchya	MALE
vairochan	MALE
vaisakhi	FEMALE
vaishali	FEMALE
vaishavi	FEMALE
vaishnavi	FEMALE
vaishnodevi	FEMALE
vaishvik	MALE
vajasani	MALE
vajendra	MALE
vajra	FEMALE
vajra	MALE
vajradhar	MALE
vajrahast	MALE
vajrajit	MALE
vajramani	MALE
vajrapani	MALE
vajrin	MALE
vakrabhuj	MALE
val?rie	FEMALE
valia	FEMALE
valini	FEMALE
vallabh	MALE
vallari	FEMALE
valli	FEMALE
vallika	FEMALE
valmik	MALE
valmiki	MALE
vama	MALE
vamadev	MALE
vamakshi	FEMALE
vaman	MALE
vamika	FEMALE
vamshi	MALE
vamsi	FEMALE
vamsi	MALE
vanad	MALE
vanadev	MALE
vanadurga	FEMALE
vanaja	FEMALE
vanajit	MALE
vanalika	FEMALE
vanamala	FEMALE
vanamalin	MALE
vanani	FEMALE
vandan	MALE
vandana	FEMALE
vandita	FEMALE
vanessa	FEMALE
vangelis	MALE
vanhi	FEMALE
vanhishikha	FEMALE
vani	FEMALE
vanij	MALE
vaninath	MALE
vanini	FEMALE
vanisha	FEMALE
vanishri	FEMALE
vanita	FEMALE
vanja	FEMALE
vanmala	FEMALE
vanmalli	FEMALE
vanmayi	FEMALE
vansh	MALE
vanshi	FEMALE
vanshika	FEMALE
vanshya	MALE
vansidhar	MALE
vara	FEMALE
varaa	FEMALE
varad	MALE
varada	FEMALE
varadraj	MALE
varali	FEMALE
varalika	FEMALE
varana	FEMALE
varana	MALE
varda	FEMALE
vardhaman	MALE
vardhan	MALE
varesh	MALE
vareshvar	MALE
vari	FEMALE
varij	FEMALE
varij	MALE
varija	FEMALE
varin	MALE
varindra	MALE
varish	MALE
variyas	MALE
varnika	FEMALE
varnit	MALE
varsha	FEMALE
varshil	MALE
vartika	FEMALE
varun	MALE
varuna	FEMALE
varunavi	FEMALE
varunesh	MALE
varuni	FEMALE
varunika	FEMALE
varya	FEMALE
vasana	FEMALE
vasant	MALE
vasanta	FEMALE
vasanti	FEMALE
vasantika	FEMALE
vasatika	FEMALE
vasav	MALE
vasava	MALE
vasavaj	MALE
vasavi	FEMALE
vasavi	MALE
vashishka	FEMALE
vashita	MALE
vasile	MALE
vasileios	MALE
vasilis	MALE
vasin	MALE
vasistha	MALE
vassia	FEMALE
vassil	MALE
vassilina	FEMALE
vassilios	MALE
vassilis	MALE
vasu	MALE
vasuda	FEMALE
vasudev	MALE
vasudeva	FEMALE
vasudha	FEMALE
vasudhara	FEMALE
vasulakshmi	FEMALE
vasuman	MALE
vasumat	MALE
vasumati	FEMALE
vasundhara	FEMALE
vasupati	MALE
vasur	MALE
vasuroop	MALE
vasvi	FEMALE
vatatmaj	MALE
vati	FEMALE
vatsa	MALE
vatsal	MALE
vatsala	FEMALE
vatsapal	MALE
vatsin	MALE
vatsla	FEMALE
vayu	MALE
vayujat	MALE
vayun	MALE
vayunand	MALE
vayya	MALE
ved	MALE
vedaant	MALE
vedamohan	MALE
vedang	MALE
vedanga	MALE
vedant	MALE
vedanti	FEMALE
vedatman	MALE
vedavrata	MALE
vedesh	MALE
vedha	FEMALE
vedi	FEMALE
vedika	FEMALE
vedmohan	MALE
vedprakash	MALE
vedrana	FEMALE
vedvalli	FEMALE
veena	FEMALE
veenapani	FEMALE
veer	MALE
veera	MALE
vela	FEMALE
velan	MALE
velli	FEMALE
venah	FEMALE
venavir	MALE
veni	MALE
venika	FEMALE
venimadhav	MALE
venisha	FEMALE
venkat	MALE
venkataraman	MALE
venkatesan	MALE
venkatesh	MALE
venkateswarlu	MALE
vennela	FEMALE
ventsislav	MALE
venu	MALE
venuka	FEMALE
venya	FEMALE
vernica	FEMALE
veronika	FEMALE
veronique	FEMALE
veselin	MALE
veska	FEMALE
vetravati	FEMALE
viamrsh	MALE
vibali	FEMALE
vibha	FEMALE
vibhaas	MALE
vibhas	MALE
vibhat	MALE
vibhav	MALE
vibhavari	FEMALE
vibhavasu	MALE
vibhi	FEMALE
vibhishan	MALE
vibhor	MALE
vibhu	MALE
vibhumat	MALE
vibhusnu	MALE
vibhut	MALE
vibhuti	FEMALE
vibodh	MALE
vibusha	FEMALE
vicent	MALE
vidas	MALE
videep	MALE
vidhatru	MALE
vidhesh	MALE
vidhi	FEMALE
vidhisha	FEMALE
vidhu	MALE
vidhut	FEMALE
vidhyalakshmi	FEMALE
vidip	MALE
vidisha	FEMALE
vidita	FEMALE
vidojas	MALE
vidula	FEMALE
vidur	MALE
vidushi	FEMALE
vidvatam	MALE
vidya	FEMALE
vidyacharan	MALE
vidyadhar	MALE
vidyanand	MALE
vidyaranya	MALE
vidyasagar	MALE
vidyul	FEMALE
vidyut	FEMALE
vidyut	MALE
vighnajit	MALE
vighnesh	MALE
vighnesh;	MALE
vigrah	MALE
vihaan	MALE
vihang	MALE
vihanga	MALE
vihari	MALE
vijanyendra	MALE
vijay	MALE
vijaya	FEMALE
vijayalakshmi	FEMALE
vijayant	MALE
vijayaraghavan	MALE
vijayasree	FEMALE
vijayendra	MALE
vijayesh	MALE
vijendra	MALE
vijeta	FEMALE
vijul	FEMALE
vijval	MALE
vikas	MALE
vikash	MALE
vikasni	FEMALE
vikesh	MALE
vikhyath	MALE
vikil	MALE
vikram	MALE
vikramaditya	MALE
vikramajit	MALE
vikramendra	MALE
vikramin	MALE
vikrant	MALE
vikranta	MALE
viksar	MALE
vikt&#243	MALE
viktor	MALE
vikunth	MALE
vilas	MALE
vilashini	FEMALE
vilasini	FEMALE
vilina	FEMALE
vilohit	MALE
vilok	MALE
vilokan	MALE
vimal	MALE
vimala	FEMALE
vimesh	MALE
vimla	FEMALE
vimple	FEMALE
vimridh	MALE
vina	FEMALE
vinahast	MALE
vinamra	FEMALE
vinanti	FEMALE
vinata	FEMALE
vinati	FEMALE
vinay	MALE
vinaya	FEMALE
vinayak	MALE
vindhya	FEMALE
vineet	MALE
vineeta	FEMALE
vinesh	MALE
vini	FEMALE
vinil	MALE
vinisha	FEMALE
vinit	MALE
vinita	FEMALE
vinochan	MALE
vinod	MALE
vinoda	FEMALE
vinodini	FEMALE
vinoth	MALE
violaine	FEMALE
violetta	FEMALE
vipan	MALE
vipanchi	FEMALE
vipasa	FEMALE
vipaschit	MALE
vipin	MALE
viplab	MALE
viplav	MALE
vipra	FEMALE
vipra	MALE
vipul	MALE
vipula	FEMALE
vir	MALE
viraaj	MALE
virabhadra	MALE
virach	MALE
viraj	MALE
viral	MALE
viranath	MALE
virat	MALE
virata	FEMALE
viren	MALE
virendra	MALE
virendri	FEMALE
viresh	MALE
vireshvar	MALE
virika	FEMALE
virikvas	MALE
virinchi	MALE
virinder	MALE
virochan	MALE
virom	MALE
virurch	MALE
visala	FEMALE
visamaksh	MALE
vishaka	FEMALE
vishakh	MALE
vishakha	FEMALE
vishal	MALE
vishala	FEMALE
vishalaksh	MALE
vishalakshi	FEMALE
vishalya	FEMALE
vishantak	MALE
vishaq	MALE
vishatan	MALE
vishaya	FEMALE
vishesh	MALE
vishnahpu	MALE
vishnu	MALE
vishnudev	MALE
vishnumaya	FEMALE
vishnupriya	FEMALE
vishodhan	MALE
vishram	MALE
vishresh	MALE
vishrut	MALE
vishva	FEMALE
vishva	MALE
vishvadev	MALE
vishvadhar	MALE
vishvag	MALE
vishvahetu	MALE
vishvajit	MALE
vishvakarma	MALE
vishvaksen	MALE
vishvamitra	MALE
vishvanabh	MALE
vishvanath	MALE
vishvaretas	MALE
vishvas	MALE
vishvatma	MALE
vishwambhar	MALE
vishwamitra	MALE
vishwanath	MALE
vishwas	MALE
vishwesh	MALE
vismay	MALE
vismaya	FEMALE
vismita	FEMALE
vistarini	FEMALE
visveshwaran	MALE
viswanath	MALE
viswarupa	FEMALE
viswas	MALE
vitabhay	MALE
vitaharya	MALE
vithala	MALE
vithika	FEMALE
viti	FEMALE
vitola	MALE
vitor	MALE
vittesh	MALE
vitthal	MALE
vittorio	MALE
vivan	MALE
vivash	MALE
vivek	MALE
viveka	FEMALE
vivekananda	MALE
vlad	MALE
vladim&#x0ed	MALE
vladimir	MALE
vladislav	MALE
vlado	MALE
vojko	MALE
volha	FEMALE
volker	MALE
voula	FEMALE
vrajabala	FEMALE
vrajakishore	MALE
vrajalal	MALE
vrajamohan	MALE
vrajanadan	MALE
vrajesh	MALE
vrajkishore	MALE
vrajmohan	MALE
vrajraj	MALE
vratesh	MALE
vriksh	MALE
vrinda	FEMALE
vrisa	MALE
vrisag	MALE
vrisan	MALE
vrisangan	MALE
vrisapati	MALE
vrischika	FEMALE
vrishab	MALE
vrishali	FEMALE
vrishank	MALE
vrishin	MALE
vrishti	FEMALE
vrisini	MALE
vritika	FEMALE
vritti	FEMALE
vrunda	FEMALE
vrushik	MALE
vrushket	MALE
vyan	MALE
vyanjana	FEMALE
vyas	MALE
vyasa	MALE
vyoman	MALE
vyomdev	MALE
vyomesh	MALE
vyomini	FEMALE
vyshakh	MALE
waa'il	MALE
waahid	MALE
wadee'	MALE
wafa	FEMALE
wafeeq	MALE
wafeeqa	FEMALE
wafiya	FEMALE
wahab	MALE
waheeda	FEMALE
wajeeh	MALE
wajeeha	FEMALE
wajidali	MALE
wakako	FEMALE
wakana	FEMALE
waleed	MALE
wali	MALE
walid	MALE
waliyudeen	MALE
waliyullah	MALE
walt	MALE
walther	MALE
waman	MALE
wamika	FEMALE
wamil	FEMALE
waotaka	MALE
warda	FEMALE
waseem	MALE
washi	MALE
washichi	MALE
wataru	MALE
wateeb	FEMALE
wattan	FEMALE
wauter	MALE
wazuka	FEMALE
wendy	FEMALE
wenhui	FEMALE
wessel	MALE
widad	FEMALE
wiebke	FEMALE
wijdan	FEMALE
wil	MALE
wilfried	MALE
wilhelm	MALE
willam	MALE
willem	MALE
willemijn	FEMALE
william	MALE
wim	MALE
winfield	MALE
winfried	MALE
wirote	MALE
wisaal	FEMALE
wisam	MALE
witold	MALE
wlodek	MALE
wlodzislaw	MALE
wm.	MALE
wojciech	MALE
wolfgang	MALE
wolfram	MALE
wolodja	MALE
won seug	MALE
wonil	MALE
woosung	MALE
wouter	MALE
wu sok	MALE
wybo	MALE
wynne	MALE
xabier	MALE
xavier	MALE
xiaodan	MALE
xiaodong	MALE
xiaotie	MALE
xitij	MALE
xuanhui	MALE
xue-qi	MALE
xuedong	MALE
ya'akov	MALE
yaakov	MALE
yaaseen	MALE
yachana	FEMALE
yachi	FEMALE
yachi	MALE
yadav	MALE
yadavendra	MALE
yadavi	FEMALE
yadunandan	MALE
yadunath	MALE
yaduraj	MALE
yaduvir	MALE
yadwinder	MALE
yae	FEMALE
yaeko	FEMALE
yael	FEMALE
yafa	FEMALE
yafiah	FEMALE
yagna	MALE
yahvi	FEMALE
yahyaa	MALE
yaichiro	MALE
yair	MALE
yaj	MALE
yajas	MALE
yajat	MALE
yajirobei	MALE
yajnadhar	MALE
yajnarup	MALE
yajnesh	MALE
yakamochi	MALE
yakootah	FEMALE
yaksha	FEMALE
yakumo	MALE
yama	FEMALE
yamahil	MALE
yamajit	MALE
yaman	MALE
yamato	MALE
yamha	FEMALE
yamini	FEMALE
yamir	MALE
yamuna	FEMALE
yamune	FEMALE
yamya	FEMALE
yanis	MALE
yann	MALE
yannick	MALE
yannis	MALE
yanti	FEMALE
yara	FEMALE
yasaar	MALE
yasemin	FEMALE
yaser	MALE
yash	MALE
yasha	FEMALE
yashas	MALE
yashashree	FEMALE
yashaswini	FEMALE
yashawini	FEMALE
yashica	FEMALE
yashila	FEMALE
yashita	FEMALE
yashna	FEMALE
yashneil	MALE
yashoda	FEMALE
yashodev	MALE
yashodhan	MALE
yashodhara	FEMALE
yashodhara	MALE
yashpal	MALE
yashvi	FEMALE
yashwant	MALE
yashwanth	MALE
yasir	MALE
yasirah	FEMALE
yasmeen	FEMALE
yasmin	FEMALE
yasmina	FEMALE
yasmine	FEMALE
yasotaro	MALE
yasti	FEMALE
yasu	FEMALE
yasuhara	MALE
yasuharu	MALE
yasuhide	MALE
yasuhiko	MALE
yasuhiro	MALE
yasuhisa	MALE
yasuhito	MALE
yasujiro	MALE
yasukazu	MALE
yasuko	FEMALE
yasunari	MALE
yasunobu	MALE
yasunori	MALE
yasuo	MALE
yasuoka	MALE
yasushi	MALE
yasusi	MALE
yasutake	MALE
yasutoki	MALE
yasutomo	MALE
yasutsugu	MALE
yasuyo	MALE
yasuyoshi	MALE
yasuyuki	MALE
yataro	MALE
yatee	FEMALE
yatin	MALE
yatindra	MALE
yatish	MALE
yatsuhiro	MALE
yaushi	MALE
yauvani	FEMALE
yavar	MALE
yavonne	FEMALE
yayin	MALE
yayoi	FEMALE
yazeed	MALE
yeha	MALE
yeijiro	MALE
yejin	FEMALE
yen-lu	MALE
yesha	FEMALE
yeshaswini	FEMALE
yeshwant	MALE
yeshwanth	MALE
yeun-bae	MALE
yevgeny	MALE
yi-gyu	MALE
yigal	MALE
yllias	MALE
yo	MALE
yoav	MALE
yochana	FEMALE
yodo	FEMALE
yodo	MALE
yoga	FEMALE
yogasri	FEMALE
yogendra	MALE
yogesh	MALE
yogi	MALE
yogini	FEMALE
yogita	FEMALE
yohachi	MALE
yohei	MALE
yohsuke	MALE
yoichi	MALE
yoichibei	MALE
yojana	FEMALE
yoji	MALE
yojna	FEMALE
yoko	FEMALE
yolotzyn	FEMALE
yoneharu	MALE
yong-gang	MALE
yong-hun	MALE
yong-won	MALE
yonggang	MALE
yongjoo	FEMALE
yoni	MALE
yookyung	FEMALE
yoon-ho	MALE
yoon-shik	MALE
yoonkwan	MALE
yoonus	MALE
yoosuf	MALE
yoram	MALE
yori	FEMALE
yori	MALE
yorick	MALE
yoriie	MALE
yorikane	MALE
yoriko	FEMALE
yoringa	MALE
yoritoki	MALE
yoritomo	MALE
yoriyoshi	MALE
yoriyuki	MALE
yosai	MALE
yoshe	FEMALE
yoshi	FEMALE
yoshi	MALE
yoshiaga	MALE
yoshiaki	MALE
yoshida	MALE
yoshie	FEMALE
yoshifumi	MALE
yoshifusa	MALE
yoshiharu	MALE
yoshihide	MALE
yoshihiko	MALE
yoshihiro	MALE
yoshihisa	MALE
yoshihito	MALE
yoshii	MALE
yoshiiku	MALE
yoshikazu	MALE
yoshike	FEMALE
yoshiki	MALE
yoshikiyo	MALE
yoshiko	FEMALE
yoshimasa	MALE
yoshimatsu	MALE
yoshimi	MALE
yoshimitsu	MALE
yoshimochi	MALE
yoshimune	MALE
yoshinaka	MALE
yoshino	FEMALE
yoshino	MALE
yoshinobu	MALE
yoshinori	MALE
yoshio	MALE
yoshiro	MALE
yoshisada	MALE
yoshitaka	MALE
yoshitake	MALE
yoshiteru	MALE
yoshito	MALE
yoshitoki	MALE
yoshitomo	MALE
yoshitora	MALE
yoshitoshi	MALE
yoshitsune	MALE
yoshiyuki	MALE
yoshua	MALE
yoson	MALE
yosuke	MALE
yotaro	MALE
youichi	MALE
young-jik	MALE
young-kil	MALE
young-soog	FEMALE
young-sook	FEMALE
young-suk	MALE
youngja	FEMALE
youngjoong	MALE
youngwhan	MALE
yousha	FEMALE
yousif	MALE
youssef	MALE
youta	MALE
yozo	MALE
yu-seop	MALE
yua	FEMALE
yubhashana	FEMALE
yudhajit	MALE
yudhishthir	MALE
yudhisthir	MALE
yudishtra	MALE
yugandhar	MALE
yugo	MALE
yugoro	MALE
yui	FEMALE
yuichi	MALE
yuichiro	MALE
yuichiroh	MALE
yuifum	MALE
yuina	FEMALE
yuji	MALE
yujiro	MALE
yuka	FEMALE
yukako	FEMALE
yukari	FEMALE
yukichi	MALE
yukie	FEMALE
yukihiko	MALE
yukihiro	MALE
yukiko	FEMALE
yukinaga	MALE
yukio	MALE
yukiyo	FEMALE
yukiyoshi	MALE
yuko	FEMALE
yuko	MALE
yulan	FEMALE
yuliya	FEMALE
yuma	FEMALE
yumako	FEMALE
yumi	FEMALE
yumiko	FEMALE
yumn	FEMALE
yunbo	MALE
yung taek	MALE
yunkeun	MALE
yunosuke	MALE
yunuen	FEMALE
yunyao	FEMALE
yuri	FEMALE
yuridia	FEMALE
yuriko	FEMALE
yushiro	MALE
yusraa	FEMALE
yusuke	FEMALE
yusuke	MALE
yuta	MALE
yutaka	MALE
yutika	FEMALE
yuu	MALE
yuudai	MALE
yuuji	MALE
yuuma	MALE
yuuna	FEMALE
yuuta	MALE
yuuto	MALE
yuvakshi	FEMALE
yuval	MALE
yuvan	MALE
yuvaraj	MALE
yuvaram	MALE
yuvarani	FEMALE
yuvati	FEMALE
yuvraj	MALE
yuyutsu	MALE
yuzo	MALE
yuzu	FEMALE
yuzuki	FEMALE
yuzuru	MALE
yvan	MALE
yves	MALE
zaafir	MALE
zaafira	FEMALE
zaahid	MALE
zaahir	MALE
zackery	MALE
zaharin	MALE
zaheeda	FEMALE
zahira	FEMALE
zahra	FEMALE
zahraa	FEMALE
zahrah	FEMALE
zaida	FEMALE
zaina	FEMALE
zainab	FEMALE
zakariya	MALE
zakhar	MALE
zakir	MALE
zakiy	MALE
zakiyaa	FEMALE
zalak	FEMALE
zankhana	FEMALE
zara	FEMALE
zarine	FEMALE
zarna	FEMALE
zayd	MALE
zbigniew	MALE
zden??k	MALE
zdenek	MALE
zdravko	MALE
zeenat	FEMALE
zeeshan	MALE
zehaan	MALE
zeljko	MALE
zenko	MALE
zeno	MALE
zenobia	FEMALE
zenon	MALE
zenshiro	MALE
zeshin	MALE
zeynep	FEMALE
ziare	MALE
ziyad	MALE
zoha	FEMALE
zohar	MALE
zoltan	MALE
zoubin	MALE
zoya	FEMALE
zubin	MALE
zuhayr	MALE
zvi	MALE
zvika	MALE
zygmunt	MALE
